,ID,DateTime,Type,Category,Description,IsCredit,IsDebit,Gross,Net,Balance,Unallocated,VAT
0,rps_lng-,2021-10-27T00:00:00+01:00,Opening Balance CR,Float,Opening Balance,False,False,,,,,
1,rps_lng-HDO21411701,2021-10-27T00:00:00+01:00,Payment,Tenant Payment,Tenancy Receipt Ref: DEFT Bpay 44815918,True,False,4302.0,4302.0,4302.0,,
2,rps_lng-HDO21411949,2021-10-28T00:00:00+01:00,Invoice,Deposit,Deposit invoice,False,True,2151.0,2151.0,2151.0,,
3,rps_lng-HDO21411950,2021-10-28T00:00:00+01:00,,Deposit,Deposit held,True,False,2151.0,2151.0,4302.0,,
4,rps_lng-HDO21428446,2021-11-08T00:00:00+00:00,Invoice,,Transfer deposit to deposit protection scheme. Ref: 15178870,False,True,2151.0,2151.0,2151.0,,
5,rps_lng-HDO21437989,2021-11-12T00:00:00+00:00,Invoice,Rent,Rent from 12/11/2021 to 11/12/2021 for 35A Cameron Street,False,True,2151.0,2151.0,,,
6,rps_lng-HDO21471059,2021-12-12T00:00:00+00:00,Invoice,Rent,Rent from 12/12/2021 to 11/01/2022 for 35A Cameron Street,False,True,2151.0,2151.0,-2151.0,,
7,rps_lng-HDO21480642,2021-12-13T00:00:00+00:00,Payment,Tenant Payment,Tenancy Receipt Ref: 35ACAMERONSTREET,True,False,2151.0,2151.0,,,
8,rps_lng-HDO22007883,2022-01-12T00:00:00+00:00,Invoice,Rent,Rent from 12/01/2022 to 11/02/2022 for 35A Cameron Street,False,True,2151.0,2151.0,-2151.0,,
9,rps_lng-HDO22017556,2022-01-12T00:00:00+00:00,Payment,Tenant Payment,Tenancy Receipt Ref: 35ACAMERONSTREET,True,False,2151.0,2151.0,,,
10,rps_lng-HDO22053514,2022-02-12T00:00:00+00:00,Invoice,Rent,Rent from 12/02/2022 to 11/03/2022 for 35A Cameron Street,False,True,2151.0,2151.0,-2151.0,,
11,rps_lng-HDO22065728,2022-02-14T00:00:00+00:00,Payment,Tenant Payment,Tenancy Receipt Ref: 35ACAMERONSTREET,True,False,2151.0,2151.0,,,
12,rps_lng-HDO22097082,2022-03-12T00:00:00+00:00,Invoice,Rent,Rent from 12/03/2022 to 11/04/2022 for 35A Cameron Street,False,True,2151.0,2151.0,-2151.0,,
13,rps_lng-HDO22110418,2022-03-15T00:00:00+00:00,Payment,Tenant Payment,Tenancy Receipt Ref: 35ACAMERONSTREET,True,False,2151.0,2151.0,,,
14,rps_lng-HDO22113607,2022-04-12T00:00:00+01:00,Invoice,Rent,Rent from 12/04/2022 to 30/04/2022 for 35A Cameron Street,False,True,1343.64,1343.64,-1343.64,,
15,rps_lng-HDO22149980,2022-04-12T00:00:00+01:00,Payment,Tenant Payment,Tenancy Receipt Ref: 35ACAMERONSTREET,True,False,1343.64,1343.64,,,
16,rps_lng-HDO22162173,2022-05-01T00:00:00+01:00,Invoice,Rent,Rent from 01/05/2022 to 31/05/2022 for 35A Cameron Street,False,True,2151.0,2151.0,-2151.0,,
17,rps_lng-HDO22177932,2022-05-02T00:00:00+01:00,Payment,Tenant Payment,Tenancy Receipt Ref: 35ACAMERONSTREET,True,False,2151.0,2151.0,,,
18,rps_lng-HDO22213552,2022-06-01T00:00:00+01:00,Invoice,Rent,Rent from 01/06/2022 to 30/06/2022 for 35A Cameron Street,False,True,2151.0,2151.0,-2151.0,,
19,rps_lng-HDO22223887,2022-06-01T00:00:00+01:00,Payment,Tenant Payment,Tenancy Receipt Ref: 35ACAMERONSTREET,True,False,2151.0,2151.0,,,
20,rps_lng-HDO22256759,2022-07-01T00:00:00+01:00,Invoice,Rent,Rent from 01/07/2022 to 31/07/2022 for 35A Cameron Street,False,True,2151.0,2151.0,-2151.0,,
21,rps_lng-HDO22271965,2022-07-01T00:00:00+01:00,Payment,Tenant Payment,Tenancy Receipt Ref: 35ACAMERONSTREET,True,False,2151.0,2151.0,,,
22,rps_lng-HDO22308667,2022-08-01T00:00:00+01:00,Invoice,Rent,Rent from 01/08/2022 to 31/08/2022 for 35A Cameron Street,False,True,2151.0,2151.0,-2151.0,,
23,rps_lng-HDO22318870,2022-08-01T00:00:00+01:00,Payment,Tenant Payment,Tenancy Receipt Ref: 35ACAMERONSTREET,True,False,2151.0,2151.0,,,
24,rps_lng-HDO22358253,2022-09-01T00:00:00+01:00,Invoice,Rent,Rent from 01/09/2022 to 30/09/2022 for 35A Cameron Street,False,True,2151.0,2151.0,-2151.0,,
25,rps_lng-HDO22370329,2022-09-01T00:00:00+01:00,Payment,Tenant Payment,Tenancy Receipt Ref: 35ACAMERONSTREET,True,False,2151.0,2151.0,,,
26,rps_lng-HDO22410376,2022-10-01T00:00:00+01:00,Invoice,Rent,Rent from 01/10/2022 to 31/10/2022 for 35A Cameron Street,False,True,2151.0,2151.0,-2151.0,,
27,rps_lng-HDO22426905,2022-10-03T00:00:00+01:00,Payment,Tenant Payment,Tenancy Receipt Ref: 35ACAMERONSTREET,True,False,2151.0,2151.0,,,
28,rps_lng-HDO22461250,2022-11-01T00:00:00+00:00,Invoice,Rent,Rent from 01/11/2022 to 30/11/2022 for 35A Cameron Street,False,True,2151.0,2151.0,-2151.0,,
29,rps_lng-HDO22474865,2022-11-02T00:00:00+00:00,Payment,Tenant Payment,Tenancy Receipt Ref: 35ACAMERONSTREET,True,False,2151.0,2151.0,,,
30,rps_lng-HDO22510171,2022-12-01T00:00:00+00:00,Invoice,Rent,Rent from 01/12/2022 to 31/12/2022 for 35A Cameron Street,False,True,2151.0,2151.0,-2151.0,,
31,rps_lng-HDO22520556,2022-12-01T00:00:00+00:00,Payment,Tenant Payment,Tenancy Receipt Ref: 35ACAMERONSTREET,True,False,2151.0,2151.0,,,
32,rps_lng-HDO22553215,2023-01-01T00:00:00+00:00,Invoice,Rent,Rent from 01/01/2023 to 31/01/2023 for 35A Cameron Street,False,True,2151.0,2151.0,-2151.0,,
33,rps_lng-HDO23004579,2023-01-03T00:00:00+00:00,Payment,Tenant Payment,Tenancy Receipt Ref: 35ACAMERONSTREET,True,False,2151.0,2151.0,,,
34,rps_lng-HDO23049909,2023-02-01T00:00:00+00:00,Payment,Tenant Payment,Tenancy Receipt Ref: 35ACAMERONSTREET,True,False,2151.0,2151.0,2151.0,,
35,rps_lng-HDO23038869,2023-02-01T00:00:00+00:00,Invoice,Rent,Rent from 01/02/2023 to 28/02/2023 for 35A Cameron Street,False,True,2151.0,2151.0,,,
36,rps_lng-HDO23052502,2023-02-03T00:00:00+00:00,Invoice,Tenant Admin Fee,Dishonour Fee,False,True,25.0,25.0,-25.0,25.0,
37,rps_lng-HDO23052501,2023-02-03T00:00:00+00:00,Debit Adjustment,Tenant Payment,Dishonoured Direct Debit: Tenancy Receipt Ref: 35ACAMERONSTREET,False,True,2151.0,2151.0,-2176.0,,
38,rps_lng-HDO23054823,2023-02-03T00:00:00+00:00,Payment,Tenant Payment,Tenancy Receipt Ref: DEFT Bpay 44815918,True,False,2151.0,2151.0,-25.0,,
39,rps_lng-HDO23084258,2023-03-01T00:00:00+00:00,Invoice,Rent,Rent from 01/03/2023 to 31/03/2023 for 35A Cameron Street,False,True,2151.0,2151.0,-2176.0,,
40,rps_lng-HDO23095725,2023-03-01T00:00:00+00:00,Payment,Tenant Payment,Tenancy Receipt Ref: 35ACAMERONSTREET,True,False,2151.0,2151.0,-25.0,,
41,rps_lng-HDO23131242,2023-04-01T00:00:00+01:00,Invoice,Rent,Rent from 01/04/2023 to 30/04/2023 for 35A Cameron Street,False,True,2151.0,2151.0,-2176.0,,
42,rps_lng-HDO23145827,2023-04-03T00:00:00+01:00,Payment,Tenant Payment,Tenancy Receipt Ref: 35ACAMERONSTREET,True,False,2151.0,2151.0,-25.0,,
43,rps_lng-HDO23176723,2023-05-01T00:00:00+01:00,Invoice,Rent,Rent from 01/05/2023 to 31/05/2023 for 35A Cameron Street,False,True,2151.0,2151.0,-2176.0,,
44,rps_lng-HDO23190197,2023-05-01T00:00:00+01:00,Payment,Tenant Payment,Tenancy Receipt Ref: 35ACAMERONSTREET,True,False,2151.0,2151.0,-25.0,,
45,rps_lng-HDO23237939,2023-06-01T00:00:00+01:00,Payment,Tenant Payment,Tenancy Receipt Ref: 35ACAMERONSTREET,True,False,2151.0,2151.0,2126.0,,
46,rps_lng-HDO23227998,2023-06-01T00:00:00+01:00,Invoice,Rent,Rent from 01/06/2023 to 30/06/2023 for 35A Cameron Street,False,True,2151.0,2151.0,-25.0,,
47,rps_lng-HDO23241438,2023-06-05T00:00:00+01:00,Invoice,Tenant Admin Fee,Dishonour Fee,False,True,25.0,25.0,-50.0,25.0,
48,rps_lng-HDO23241437,2023-06-05T00:00:00+01:00,Debit Adjustment,Tenant Payment,Dishonoured Direct Debit: Tenancy Receipt Ref: 35ACAMERONSTREET,False,True,2151.0,2151.0,-2201.0,,
49,rps_lng-HDO23242879,2023-06-05T00:00:00+01:00,Payment,Tenant Payment,Tenancy Receipt Ref: DEFT Bpay 44815918,True,False,2151.0,2151.0,-50.0,,
50,rps_lng-HDO23272494,2023-07-01T00:00:00+01:00,Invoice,Rent,Rent from 01/07/2023 to 31/07/2023 for 35A Cameron Street,False,True,2151.0,2151.0,-2201.0,,
51,rps_lng-HDO23288006,2023-07-03T00:00:00+01:00,Payment,Tenant Payment,Tenancy Receipt Ref: 35ACAMERONSTREET,True,False,2151.0,2151.0,-50.0,,
52,rps_lng-HDO23325590,2023-08-01T00:00:00+01:00,Invoice,Rent,Rent from 01/08/2023 to 31/08/2023 for 35A Cameron Street,False,True,2151.0,2151.0,-2201.0,,
53,rps_lng-HDO23336706,2023-08-01T00:00:00+01:00,Payment,Tenant Payment,Tenancy Receipt Ref: 35ACAMERONSTREET,True,False,2151.0,2151.0,-50.0,,
54,rps_lng-,2021-02-01T00:00:00+00:00,Opening Balance CR,Float,Opening Balance,False,False,,,,,
55,rps_lng-HDO21032685,2021-02-01T00:00:00+00:00,Invoice,Rent,Rent from 01/02/2021 to 28/02/2021 for 124 Leicester Street,False,True,3086.0,3086.0,-3086.0,,
56,rps_lng-HDO21036466,2021-02-01T00:00:00+00:00,Payment,Tenant Payment,Tenancy Receipt Ref: 124LEICESTERSTRE-2,True,False,3086.0,3086.0,,,
57,rps_lng-HDO21064557,2021-03-01T00:00:00+00:00,Invoice,Rent,Rent from 01/03/2021 to 31/03/2021 for 124 Leicester Street,False,True,3086.0,3086.0,-3086.0,,
58,rps_lng-HDO21075067,2021-03-01T00:00:00+00:00,Payment,Tenant Payment,Tenancy Receipt Ref: 124LEICESTERSTRE-2,True,False,3086.0,3086.0,,,
59,rps_lng-HDO21105332,2021-04-01T00:00:00+01:00,Invoice,Rent,Rent from 01/04/2021 to 30/04/2021 for 124 Leicester Street,False,True,3086.0,3086.0,-3086.0,,
60,rps_lng-HDO21116343,2021-04-01T00:00:00+01:00,Payment,Tenant Payment,Tenancy Receipt Ref: 124LEICESTERSTRE-2,True,False,3086.0,3086.0,,,
61,rps_lng-HDO21140638,2021-05-01T00:00:00+01:00,Invoice,Rent,Rent from 01/05/2021 to 31/05/2021 for 124 Leicester Street,False,True,3086.0,3086.0,-3086.0,,
62,rps_lng-HDO21155851,2021-05-03T00:00:00+01:00,Payment,Tenant Payment,Tenancy Receipt Ref: 124LEICESTERSTRE-2,True,False,3086.0,3086.0,,,
63,rps_lng-HDO21184418,2021-06-01T00:00:00+01:00,Invoice,Rent,Rent from 01/06/2021 to 30/06/2021 for 124 Leicester Street,False,True,3086.0,3086.0,-3086.0,,
64,rps_lng-HDO21194446,2021-06-01T00:00:00+01:00,Payment,Tenant Payment,Tenancy Receipt Ref: 124LEICESTERSTRE-2,True,False,3086.0,3086.0,,,
65,rps_lng-HDO21226276,2021-07-01T00:00:00+01:00,Invoice,Rent,Rent from 01/07/2021 to 31/07/2021 for 124 Leicester Street,False,True,3086.0,3086.0,-3086.0,,
66,rps_lng-HDO21237789,2021-07-01T00:00:00+01:00,Payment,Tenant Payment,Tenancy Receipt Ref: 124LEICESTERSTRE-2,True,False,3086.0,3086.0,,,
67,rps_lng-HDO21271858,2021-08-01T00:00:00+01:00,Invoice,Rent,Rent from 01/08/2021 to 31/08/2021 for 124 Leicester Street,False,True,3086.0,3086.0,-3086.0,,
68,rps_lng-HDO21282564,2021-08-02T00:00:00+01:00,Payment,Tenant Payment,Tenancy Receipt Ref: 124LEICESTERSTRE-2,True,False,3086.0,3086.0,,,
69,rps_lng-HDO21316179,2021-09-01T00:00:00+01:00,Invoice,Rent,Rent from 01/09/2021 to 30/09/2021 for 124 Leicester Street,False,True,3086.0,3086.0,-3086.0,,
70,rps_lng-HDO21328942,2021-09-01T00:00:00+01:00,Payment,Tenant Payment,Tenancy Receipt Ref: 124LEICESTERSTRE-2,True,False,3086.0,3086.0,,,
71,rps_lng-HDO21361097,2021-10-01T00:00:00+01:00,Invoice,Rent,Rent from 01/10/2021 to 31/10/2021 for 124 Leicester Street,False,True,3086.0,3086.0,-3086.0,,
72,rps_lng-HDO21375054,2021-10-01T00:00:00+01:00,Payment,Tenant Payment,Tenancy Receipt Ref: 124LEICESTERSTRE-2,True,False,3086.0,3086.0,,,
73,rps_lng-HDO21407321,2021-11-01T00:00:00+00:00,Invoice,Rent,Rent from 01/11/2021 to 30/11/2021 for 124 Leicester Street,False,True,3086.0,3086.0,-3086.0,,
74,rps_lng-HDO21419965,2021-11-01T00:00:00+00:00,Payment,Tenant Payment,Tenancy Receipt Ref: 124LEICESTERSTRE-2,True,False,3086.0,3086.0,,,
75,rps_lng-HDO21451611,2021-12-01T00:00:00+00:00,Invoice,Rent,Rent from 01/12/2021 to 31/12/2021 for 124 Leicester Street,False,True,3086.0,3086.0,-3086.0,,
76,rps_lng-HDO21462529,2021-12-01T00:00:00+00:00,Payment,Tenant Payment,Tenancy Receipt Ref: 124LEICESTERSTRE-2,True,False,3086.0,3086.0,,,
77,rps_lng-HDO21494223,2022-01-01T00:00:00+00:00,Invoice,Rent,Rent from 01/01/2022 to 31/01/2022 for 124 Leicester Street,False,True,3086.0,3086.0,-3086.0,,
78,rps_lng-HDO22005443,2022-01-04T00:00:00+00:00,Payment,Tenant Payment,Tenancy Receipt Ref: 124LEICESTERSTRE-2,True,False,3086.0,3086.0,,,
79,rps_lng-HDO22034120,2022-02-01T00:00:00+00:00,Invoice,Rent,Rent from 01/02/2022 to 28/02/2022 for 124 Leicester Street,False,True,3086.0,3086.0,-3086.0,,
80,rps_lng-HDO22046904,2022-02-01T00:00:00+00:00,Payment,Tenant Payment,Tenancy Receipt Ref: 124LEICESTERSTRE-2,True,False,3086.0,3086.0,,,
81,rps_lng-HDO22078763,2022-03-01T00:00:00+00:00,Invoice,Rent,Rent from 01/03/2022 to 31/03/2022 for 124 Leicester Street,False,True,3086.0,3086.0,-3086.0,,
82,rps_lng-HDO22090939,2022-03-01T00:00:00+00:00,Payment,Tenant Payment,Tenancy Receipt Ref: 124LEICESTERSTRE-2,True,False,3086.0,3086.0,,,
83,rps_lng-HDO22123009,2022-04-01T00:00:00+01:00,Invoice,Rent,Rent from 01/04/2022 to 30/04/2022 for 124 Leicester Street,False,True,3086.0,3086.0,-3086.0,,
84,rps_lng-HDO22135348,2022-04-01T00:00:00+01:00,Payment,Tenant Payment,Tenancy Receipt Ref: 124LEICESTERSTRE-2,True,False,3086.0,3086.0,,,
85,rps_lng-HDO22162205,2022-05-01T00:00:00+01:00,Invoice,Rent,Rent from 01/05/2022 to 31/05/2022 for 124 Leicester Street,False,True,3086.0,3086.0,-3086.0,,
86,rps_lng-HDO22178624,2022-05-02T00:00:00+01:00,Payment,Tenant Payment,Tenancy Receipt Ref: 124LEICESTERSTRE-2,True,False,3086.0,3086.0,,,
87,rps_lng-HDO22213565,2022-06-01T00:00:00+01:00,Invoice,Rent,Rent from 01/06/2022 to 30/06/2022 for 124 Leicester Street,False,True,3086.0,3086.0,-3086.0,,
88,rps_lng-HDO22224628,2022-06-01T00:00:00+01:00,Payment,Tenant Payment,Tenancy Receipt Ref: 124LEICESTERSTRE-2,True,False,3086.0,3086.0,,,
89,rps_lng-HDO22256768,2022-07-01T00:00:00+01:00,Invoice,Rent,Rent from 01/07/2022 to 31/07/2022 for 124 Leicester Street,False,True,3086.0,3086.0,-3086.0,,
90,rps_lng-HDO22272680,2022-07-01T00:00:00+01:00,Payment,Tenant Payment,Tenancy Receipt Ref: 124LEICESTERSTRE-2,True,False,3086.0,3086.0,,,
91,rps_lng-HDO22308689,2022-08-01T00:00:00+01:00,Invoice,Rent,Rent from 01/08/2022 to 31/08/2022 for 124 Leicester Street,False,True,3086.0,3086.0,-3086.0,,
92,rps_lng-HDO22319406,2022-08-01T00:00:00+01:00,Payment,Tenant Payment,Tenancy Receipt Ref: 124LEICESTERSTRE-2,True,False,3086.0,3086.0,,,
93,rps_lng-HDO22358264,2022-09-01T00:00:00+01:00,Invoice,Rent,Rent from 01/09/2022 to 30/09/2022 for 124 Leicester Street,False,True,3086.0,3086.0,-3086.0,,
94,rps_lng-HDO22370892,2022-09-01T00:00:00+01:00,Payment,Tenant Payment,Tenancy Receipt Ref: 124LEICESTERSTRE-2,True,False,3086.0,3086.0,,,
95,rps_lng-HDO22410400,2022-10-01T00:00:00+01:00,Invoice,Rent,Rent from 01/10/2022 to 31/10/2022 for 124 Leicester Street,False,True,3086.0,3086.0,-3086.0,,
96,rps_lng-HDO22427322,2022-10-03T00:00:00+01:00,Payment,Tenant Payment,Tenancy Receipt Ref: 124LEICESTERSTRE-2,True,False,3086.0,3086.0,,,
97,rps_lng-HDO22461266,2022-11-01T00:00:00+00:00,Invoice,Rent,Rent from 01/11/2022 to 30/11/2022 for 124 Leicester Street,False,True,3086.0,3086.0,-3086.0,,
98,rps_lng-HDO22475244,2022-11-02T00:00:00+00:00,Payment,Tenant Payment,Tenancy Receipt Ref: 124LEICESTERSTRE-2,True,False,3086.0,3086.0,,,
99,rps_lng-HDO22510184,2022-12-01T00:00:00+00:00,Invoice,Rent,Rent from 01/12/2022 to 31/12/2022 for 124 Leicester Street,False,True,3086.0,3086.0,-3086.0,,
100,rps_lng-HDO22520902,2022-12-01T00:00:00+00:00,Payment,Tenant Payment,Tenancy Receipt Ref: 124LEICESTERSTRE-2,True,False,3086.0,3086.0,,,
101,rps_lng-HDO22553226,2023-01-01T00:00:00+00:00,Invoice,Rent,Rent from 01/01/2023 to 31/01/2023 for 124 Leicester Street,False,True,3086.0,3086.0,-3086.0,,
102,rps_lng-HDO23004985,2023-01-03T00:00:00+00:00,Payment,Tenant Payment,Tenancy Receipt Ref: 124LEICESTERSTRE-2,True,False,3086.0,3086.0,,,
103,rps_lng-HDO23038906,2023-02-01T00:00:00+00:00,Invoice,Rent,Rent from 01/02/2023 to 28/02/2023 for 124 Leicester Street,False,True,3086.0,3086.0,-3086.0,,
104,rps_lng-HDO23050422,2023-02-01T00:00:00+00:00,Payment,Tenant Payment,Tenancy Receipt Ref: 124LEICESTERSTRE-2,True,False,3086.0,3086.0,,,
105,rps_lng-HDO23084252,2023-03-01T00:00:00+00:00,Invoice,Rent,Rent from 01/03/2023 to 31/03/2023 for 124 Leicester Street,False,True,3086.0,3086.0,-3086.0,,
106,rps_lng-HDO23096038,2023-03-01T00:00:00+00:00,Payment,Tenant Payment,Tenancy Receipt Ref: 124LEICESTERSTRE-2,True,False,3086.0,3086.0,,,
107,rps_lng-HDO23131267,2023-04-01T00:00:00+01:00,Invoice,Rent,Rent from 01/04/2023 to 30/04/2023 for 124 Leicester Street,False,True,3086.0,3086.0,-3086.0,,
108,rps_lng-HDO23146570,2023-04-03T00:00:00+01:00,Payment,Tenant Payment,Tenancy Receipt Ref: 124LEICESTERSTRE-2,True,False,3086.0,3086.0,,,
109,rps_lng-HDO23176726,2023-05-01T00:00:00+01:00,Invoice,Rent,Rent from 01/05/2023 to 31/05/2023 for 124 Leicester Street,False,True,3086.0,3086.0,-3086.0,,
110,rps_lng-HDO23190566,2023-05-01T00:00:00+01:00,Payment,Tenant Payment,Tenancy Receipt Ref: 124LEICESTERSTRE-2,True,False,3086.0,3086.0,,,
111,rps_lng-HDO23228007,2023-06-01T00:00:00+01:00,Invoice,Rent,Rent from 01/06/2023 to 30/06/2023 for 124 Leicester Street,False,True,3086.0,3086.0,-3086.0,,
112,rps_lng-HDO23238228,2023-06-01T00:00:00+01:00,Payment,Tenant Payment,Tenancy Receipt Ref: 124LEICESTERSTRE-2,True,False,3086.0,3086.0,,,
113,rps_lng-HDO23272497,2023-07-01T00:00:00+01:00,Invoice,Rent,Rent from 01/07/2023 to 31/07/2023 for 124 Leicester Street,False,True,3086.0,3086.0,-3086.0,,
114,rps_lng-HDO23288337,2023-07-03T00:00:00+01:00,Payment,Tenant Payment,Tenancy Receipt Ref: 124LEICESTERSTRE-2,True,False,3086.0,3086.0,,,
115,rps_lng-HDO23325690,2023-08-01T00:00:00+01:00,Invoice,Rent,Rent from 01/08/2023 to 31/08/2023 for 124 Leicester Street,False,True,3086.0,3086.0,-3086.0,,
116,rps_lng-HDO23337317,2023-08-01T00:00:00+01:00,Payment,Tenant Payment,Tenancy Receipt Ref: 124LEICESTERSTRE-2,True,False,3086.0,3086.0,,,
117,rps_lng-,2021-02-15T00:00:00+00:00,Opening Balance CR,Float,Opening Balance,False,False,,,,,
118,rps_lng-HDO21054898,2021-02-15T00:00:00+00:00,Payment,Tenant Payment,Tenancy Receipt Ref: DEFT Bpay 42354241,True,False,2348.0,2348.0,2348.0,,
119,rps_lng-HDO21055158,2021-02-16T00:00:00+00:00,Invoice,Deposit,Deposit invoice,False,True,1174.0,1174.0,1174.0,,
120,rps_lng-HDO21055159,2021-02-16T00:00:00+00:00,,Deposit,Deposit held,True,False,1174.0,1174.0,2348.0,,
121,rps_lng-HDO21056491,2021-02-17T00:00:00+00:00,Invoice,,Transfer deposit to deposit protection scheme. Ref: 14993742,False,True,1174.0,1174.0,1174.0,,
122,rps_lng-HDO21057949,2021-02-19T00:00:00+00:00,Invoice,Rent,Rent from 19/02/2021 to 18/03/2021 for 15/88 Franklin Street,False,True,1174.0,1174.0,,,
123,rps_lng-HDO21094719,2021-03-16T00:00:00+00:00,Payment,Tenant Payment,Tenancy Receipt Ref: DEFT Bpay 42354241,True,False,1174.0,1174.0,1174.0,,
124,rps_lng-HDO21090464,2021-03-19T00:00:00+00:00,Invoice,Rent,Rent from 19/03/2021 to 18/04/2021 for 15/88 Franklin Street,False,True,1174.0,1174.0,,,
125,rps_lng-HDO21129056,2021-04-19T00:00:00+01:00,Invoice,Rent,Rent from 19/04/2021 to 18/05/2021 for 15/88 Franklin Street,False,True,1174.0,1174.0,-1174.0,,
126,rps_lng-HDO21135173,2021-04-19T00:00:00+01:00,Payment,Tenant Payment,Tenancy Receipt Ref: DEFT Bpay 42354241,True,False,1174.0,1174.0,,,
127,rps_lng-HDO21173836,2021-05-17T00:00:00+01:00,Payment,Tenant Payment,Tenancy Receipt Ref: DEFT Bpay 42354241,True,False,1174.0,1174.0,1174.0,,
128,rps_lng-HDO21169505,2021-05-19T00:00:00+01:00,Invoice,Rent,Rent from 19/05/2021 to 18/06/2021 for 15/88 Franklin Street,False,True,1174.0,1174.0,,,
129,rps_lng-HDO21216729,2021-06-17T00:00:00+01:00,Payment,Tenant Payment,Tenancy Receipt Ref: DEFT Bpay 42354241,True,False,1174.0,1174.0,1174.0,,
130,rps_lng-HDO21210112,2021-06-19T00:00:00+01:00,Invoice,Rent,Rent from 19/06/2021 to 18/07/2021 for 15/88 Franklin Street,False,True,1174.0,1174.0,,,
131,rps_lng-HDO21255618,2021-07-19T00:00:00+01:00,Invoice,Rent,Rent from 19/07/2021 to 18/08/2021 for 15/88 Franklin Street,False,True,1174.0,1174.0,-1174.0,,
132,rps_lng-HDO21262792,2021-07-19T00:00:00+01:00,Payment,Tenant Payment,Tenancy Receipt Ref: DEFT Bpay 42354241,True,False,1174.0,1174.0,,,
133,rps_lng-HDO21302416,2021-08-16T00:00:00+01:00,Payment,Tenant Payment,Tenancy Receipt Ref: DEFT Bpay 42354241,True,False,1174.0,1174.0,1174.0,,
134,rps_lng-HDO21299191,2021-08-19T00:00:00+01:00,Invoice,Rent,Rent from 19/08/2021 to 18/09/2021 for 15/88 Franklin Street,False,True,1174.0,1174.0,,,
135,rps_lng-HDO21351375,2021-09-16T00:00:00+01:00,Invoice,,Water Usage Reimbursement - 13/05/21 - 09/08/21,False,True,104.53,104.53,-104.53,,
136,rps_lng-HDO21346370,2021-09-19T00:00:00+01:00,Invoice,Rent,Rent from 19/09/2021 to 18/10/2021 for 15/88 Franklin Street,False,True,1174.0,1174.0,-1278.53,,
137,rps_lng-HDO21355251,2021-09-20T00:00:00+01:00,Payment,Tenant Payment,Tenancy Receipt Ref: DEFT Bpay 42354241,True,False,1278.53,1278.53,,,
138,rps_lng-HDO21391519,2021-10-13T00:00:00+01:00,Payment,Tenant Payment,Tenancy Receipt Ref: DEFT I/CCd VI 0042354241,True,False,1174.0,1174.0,1174.0,,
139,rps_lng-HDO21391065,2021-10-19T00:00:00+01:00,Invoice,Rent,Rent from 19/10/2021 to 18/11/2021 for 15/88 Franklin Street,False,True,1174.0,1174.0,,,
140,rps_lng-HDO21440679,2021-11-16T00:00:00+00:00,Payment,Tenant Payment,Tenancy Receipt Ref: DEFT Bpay - 42354241 27639,True,False,1174.0,1174.0,1174.0,,
141,rps_lng-HDO21435754,2021-11-19T00:00:00+00:00,Invoice,Rent,Rent from 19/11/2021 to 18/12/2021 for 15/88 Franklin Street,False,True,1174.0,1174.0,,,
142,rps_lng-HDO21479791,2021-12-19T00:00:00+00:00,Invoice,Rent,Rent from 19/12/2021 to 18/01/2022 for 15/88 Franklin Street,False,True,1174.0,1174.0,-1174.0,,
143,rps_lng-HDO21488630,2021-12-20T00:00:00+00:00,Payment,Tenant Payment,Tenancy Receipt Ref: DEFT Bpay - 42354241 45553,True,False,1174.0,1174.0,,,
144,rps_lng-HDO22022400,2022-01-17T00:00:00+00:00,Payment,Tenant Payment,Tenancy Receipt Ref: DEFT Bpay - 42354241 49445,True,False,1174.0,1174.0,1174.0,,
145,rps_lng-HDO22018340,2022-01-19T00:00:00+00:00,Invoice,Rent,Rent from 19/01/2022 to 18/02/2022 for 15/88 Franklin Street,False,True,1174.0,1174.0,,,
146,rps_lng-HDO22067280,2022-02-15T00:00:00+00:00,Payment,Tenant Payment,Tenancy Receipt Ref: DEFT Bpay 42354241,True,False,540.36,540.36,540.36,,
147,rps_lng-HDO22062373,2022-02-19T00:00:00+00:00,Invoice,Rent,Rent from 19/02/2022 to 04/03/2022 for 15/88 Franklin Street,False,True,540.36,540.36,,,
148,rps_lng-HDO22094432,2022-03-03T00:00:00+00:00,Payment,Tenant Payment,Tenancy Receipt Ref: DEFT Bpay 46464111,True,False,2868.0,2868.0,2868.0,,
149,rps_lng-HDO22094716,2022-03-04T00:00:00+00:00,Invoice,Deposit,Deposit invoice,False,True,1434.0,1434.0,1434.0,,
150,rps_lng-HDO22094717,2022-03-04T00:00:00+00:00,,Deposit,Deposit held,True,False,1434.0,1434.0,2868.0,,
151,rps_lng-HDO22098543,2022-03-07T00:00:00+00:00,Invoice,,Transfer deposit to deposit protection scheme. Ref: 15273502,False,True,1434.0,1434.0,1434.0,,
152,rps_lng-HDO22105214,2022-03-08T00:00:00+00:00,Invoice,Rent,Rent from 08/03/2022 to 07/04/2022 for 15/88 Franklin Street,False,True,1434.0,1434.0,,,
153,rps_lng-HDO22133026,2022-04-08T00:00:00+01:00,Invoice,Rent,Rent from 08/04/2022 to 07/05/2022 for 15/88 Franklin Street,False,True,1434.0,1434.0,-1434.0,,
154,rps_lng-HDO22146421,2022-04-08T00:00:00+01:00,Payment,Tenant Payment,Tenancy Receipt Ref: 15/88FRANKLINSTREE,True,False,1434.0,1434.0,,,
155,rps_lng-HDO22176458,2022-05-08T00:00:00+01:00,Invoice,Rent,Rent from 08/05/2022 to 07/06/2022 for 15/88 Franklin Street,False,True,1434.0,1434.0,-1434.0,,
156,rps_lng-HDO22191069,2022-05-09T00:00:00+01:00,Payment,Tenant Payment,Tenancy Receipt Ref: 15/88FRANKLINSTREE,True,False,1434.0,1434.0,,,
157,rps_lng-HDO22226043,2022-06-08T00:00:00+01:00,Invoice,Rent,Rent from 08/06/2022 to 07/07/2022 for 15/88 Franklin Street,False,True,1434.0,1434.0,-1434.0,,
158,rps_lng-HDO22235829,2022-06-08T00:00:00+01:00,Payment,Tenant Payment,Tenancy Receipt Ref: 15/88FRANKLINSTREE,True,False,1434.0,1434.0,,,
159,rps_lng-HDO22270168,2022-07-08T00:00:00+01:00,Invoice,Rent,Rent from 08/07/2022 to 07/08/2022 for 15/88 Franklin Street,False,True,1434.0,1434.0,-1434.0,,
160,rps_lng-HDO22284385,2022-07-08T00:00:00+01:00,Payment,Tenant Payment,Tenancy Receipt Ref: 15/88FRANKLINSTREE,True,False,1434.0,1434.0,,,
161,rps_lng-HDO22320670,2022-08-08T00:00:00+01:00,Invoice,Rent,Rent from 08/08/2022 to 07/09/2022 for 15/88 Franklin Street,False,True,1434.0,1434.0,-1434.0,,
162,rps_lng-HDO22330546,2022-08-08T00:00:00+01:00,Payment,Tenant Payment,Tenancy Receipt Ref: 15/88FRANKLINSTREE,True,False,1434.0,1434.0,,,
163,rps_lng-HDO22372210,2022-09-08T00:00:00+01:00,Invoice,Rent,Rent from 08/09/2022 to 07/10/2022 for 15/88 Franklin Street,False,True,1434.0,1434.0,-1434.0,,
164,rps_lng-HDO22387174,2022-09-08T00:00:00+01:00,Payment,Tenant Payment,Tenancy Receipt Ref: 15/88FRANKLINSTREE,True,False,1434.0,1434.0,,,
165,rps_lng-HDO22423373,2022-10-08T00:00:00+01:00,Invoice,Rent,Rent from 08/10/2022 to 07/11/2022 for 15/88 Franklin Street,False,True,1434.0,1434.0,-1434.0,,
166,rps_lng-HDO22439605,2022-10-10T00:00:00+01:00,Payment,Tenant Payment,Tenancy Receipt Ref: 15/88FRANKLINSTREE,True,False,1434.0,1434.0,,,
167,rps_lng-HDO22474134,2022-11-08T00:00:00+00:00,Invoice,Rent,Rent from 08/11/2022 to 07/12/2022 for 15/88 Franklin Street,False,True,1434.0,1434.0,-1434.0,,
168,rps_lng-HDO22485680,2022-11-08T00:00:00+00:00,Payment,Tenant Payment,Tenancy Receipt Ref: 15/88FRANKLINSTREE,True,False,1434.0,1434.0,,,
169,rps_lng-HDO22522451,2022-12-08T00:00:00+00:00,Invoice,Rent,Rent from 08/12/2022 to 07/01/2023 for 15/88 Franklin Street,False,True,1434.0,1434.0,-1434.0,,
170,rps_lng-HDO22532496,2022-12-08T00:00:00+00:00,Payment,Tenant Payment,Tenancy Receipt Ref: 15/88FRANKLINSTREE,True,False,1434.0,1434.0,,,
171,rps_lng-HDO23000154,2023-01-08T00:00:00+00:00,Invoice,Rent,Rent from 08/01/2023 to 07/02/2023 for 15/88 Franklin Street,False,True,1434.0,1434.0,-1434.0,,
172,rps_lng-HDO23015725,2023-01-09T00:00:00+00:00,Payment,Tenant Payment,Tenancy Receipt Ref: 15/88FRANKLINSTREE,True,False,1434.0,1434.0,,,
173,rps_lng-HDO23051737,2023-02-08T00:00:00+00:00,Invoice,Rent,Rent from 08/02/2023 to 07/03/2023 for 15/88 Franklin Street,False,True,1434.0,1434.0,-1434.0,,
174,rps_lng-HDO23061245,2023-02-08T00:00:00+00:00,Payment,Tenant Payment,Tenancy Receipt Ref: 15/88FRANKLINSTREE,True,False,1434.0,1434.0,,,
175,rps_lng-,2021-02-15T00:00:00+00:00,Opening Balance CR,Float,Opening Balance,False,False,,,,,
176,rps_lng-HDO21054898,2021-02-15T00:00:00+00:00,Payment,Tenant Payment,Tenancy Receipt Ref: DEFT Bpay 42354241,True,False,2348.0,2348.0,2348.0,,
177,rps_lng-HDO21055158,2021-02-16T00:00:00+00:00,Invoice,Deposit,Deposit invoice,False,True,1174.0,1174.0,1174.0,,
178,rps_lng-HDO21055159,2021-02-16T00:00:00+00:00,,Deposit,Deposit held,True,False,1174.0,1174.0,2348.0,,
179,rps_lng-HDO21056491,2021-02-17T00:00:00+00:00,Invoice,,Transfer deposit to deposit protection scheme. Ref: 14993742,False,True,1174.0,1174.0,1174.0,,
180,rps_lng-HDO21057949,2021-02-19T00:00:00+00:00,Invoice,Rent,Rent from 19/02/2021 to 18/03/2021 for 15/88 Franklin Street,False,True,1174.0,1174.0,,,
181,rps_lng-HDO21094719,2021-03-16T00:00:00+00:00,Payment,Tenant Payment,Tenancy Receipt Ref: DEFT Bpay 42354241,True,False,1174.0,1174.0,1174.0,,
182,rps_lng-HDO21090464,2021-03-19T00:00:00+00:00,Invoice,Rent,Rent from 19/03/2021 to 18/04/2021 for 15/88 Franklin Street,False,True,1174.0,1174.0,,,
183,rps_lng-HDO21129056,2021-04-19T00:00:00+01:00,Invoice,Rent,Rent from 19/04/2021 to 18/05/2021 for 15/88 Franklin Street,False,True,1174.0,1174.0,-1174.0,,
184,rps_lng-HDO21135173,2021-04-19T00:00:00+01:00,Payment,Tenant Payment,Tenancy Receipt Ref: DEFT Bpay 42354241,True,False,1174.0,1174.0,,,
185,rps_lng-HDO21173836,2021-05-17T00:00:00+01:00,Payment,Tenant Payment,Tenancy Receipt Ref: DEFT Bpay 42354241,True,False,1174.0,1174.0,1174.0,,
186,rps_lng-HDO21169505,2021-05-19T00:00:00+01:00,Invoice,Rent,Rent from 19/05/2021 to 18/06/2021 for 15/88 Franklin Street,False,True,1174.0,1174.0,,,
187,rps_lng-HDO21216729,2021-06-17T00:00:00+01:00,Payment,Tenant Payment,Tenancy Receipt Ref: DEFT Bpay 42354241,True,False,1174.0,1174.0,1174.0,,
188,rps_lng-HDO21210112,2021-06-19T00:00:00+01:00,Invoice,Rent,Rent from 19/06/2021 to 18/07/2021 for 15/88 Franklin Street,False,True,1174.0,1174.0,,,
189,rps_lng-HDO21255618,2021-07-19T00:00:00+01:00,Invoice,Rent,Rent from 19/07/2021 to 18/08/2021 for 15/88 Franklin Street,False,True,1174.0,1174.0,-1174.0,,
190,rps_lng-HDO21262792,2021-07-19T00:00:00+01:00,Payment,Tenant Payment,Tenancy Receipt Ref: DEFT Bpay 42354241,True,False,1174.0,1174.0,,,
191,rps_lng-HDO21302416,2021-08-16T00:00:00+01:00,Payment,Tenant Payment,Tenancy Receipt Ref: DEFT Bpay 42354241,True,False,1174.0,1174.0,1174.0,,
192,rps_lng-HDO21299191,2021-08-19T00:00:00+01:00,Invoice,Rent,Rent from 19/08/2021 to 18/09/2021 for 15/88 Franklin Street,False,True,1174.0,1174.0,,,
193,rps_lng-HDO21351375,2021-09-16T00:00:00+01:00,Invoice,,Water Usage Reimbursement - 13/05/21 - 09/08/21,False,True,104.53,104.53,-104.53,,
194,rps_lng-HDO21346370,2021-09-19T00:00:00+01:00,Invoice,Rent,Rent from 19/09/2021 to 18/10/2021 for 15/88 Franklin Street,False,True,1174.0,1174.0,-1278.53,,
195,rps_lng-HDO21355251,2021-09-20T00:00:00+01:00,Payment,Tenant Payment,Tenancy Receipt Ref: DEFT Bpay 42354241,True,False,1278.53,1278.53,,,
196,rps_lng-HDO21391519,2021-10-13T00:00:00+01:00,Payment,Tenant Payment,Tenancy Receipt Ref: DEFT I/CCd VI 0042354241,True,False,1174.0,1174.0,1174.0,,
197,rps_lng-HDO21391065,2021-10-19T00:00:00+01:00,Invoice,Rent,Rent from 19/10/2021 to 18/11/2021 for 15/88 Franklin Street,False,True,1174.0,1174.0,,,
198,rps_lng-HDO21440679,2021-11-16T00:00:00+00:00,Payment,Tenant Payment,Tenancy Receipt Ref: DEFT Bpay - 42354241 27639,True,False,1174.0,1174.0,1174.0,,
199,rps_lng-HDO21435754,2021-11-19T00:00:00+00:00,Invoice,Rent,Rent from 19/11/2021 to 18/12/2021 for 15/88 Franklin Street,False,True,1174.0,1174.0,,,
200,rps_lng-HDO21479791,2021-12-19T00:00:00+00:00,Invoice,Rent,Rent from 19/12/2021 to 18/01/2022 for 15/88 Franklin Street,False,True,1174.0,1174.0,-1174.0,,
201,rps_lng-HDO21488630,2021-12-20T00:00:00+00:00,Payment,Tenant Payment,Tenancy Receipt Ref: DEFT Bpay - 42354241 45553,True,False,1174.0,1174.0,,,
202,rps_lng-HDO22022400,2022-01-17T00:00:00+00:00,Payment,Tenant Payment,Tenancy Receipt Ref: DEFT Bpay - 42354241 49445,True,False,1174.0,1174.0,1174.0,,
203,rps_lng-HDO22018340,2022-01-19T00:00:00+00:00,Invoice,Rent,Rent from 19/01/2022 to 18/02/2022 for 15/88 Franklin Street,False,True,1174.0,1174.0,,,
204,rps_lng-HDO22067280,2022-02-15T00:00:00+00:00,Payment,Tenant Payment,Tenancy Receipt Ref: DEFT Bpay 42354241,True,False,540.36,540.36,540.36,,
205,rps_lng-HDO22062373,2022-02-19T00:00:00+00:00,Invoice,Rent,Rent from 19/02/2022 to 04/03/2022 for 15/88 Franklin Street,False,True,540.36,540.36,,,
206,rps_lng-HDO22094432,2022-03-03T00:00:00+00:00,Payment,Tenant Payment,Tenancy Receipt Ref: DEFT Bpay 46464111,True,False,2868.0,2868.0,2868.0,,
207,rps_lng-HDO22094716,2022-03-04T00:00:00+00:00,Invoice,Deposit,Deposit invoice,False,True,1434.0,1434.0,1434.0,,
208,rps_lng-HDO22094717,2022-03-04T00:00:00+00:00,,Deposit,Deposit held,True,False,1434.0,1434.0,2868.0,,
209,rps_lng-HDO22098543,2022-03-07T00:00:00+00:00,Invoice,,Transfer deposit to deposit protection scheme. Ref: 15273502,False,True,1434.0,1434.0,1434.0,,
210,rps_lng-HDO22105214,2022-03-08T00:00:00+00:00,Invoice,Rent,Rent from 08/03/2022 to 07/04/2022 for 15/88 Franklin Street,False,True,1434.0,1434.0,,,
211,rps_lng-HDO22133026,2022-04-08T00:00:00+01:00,Invoice,Rent,Rent from 08/04/2022 to 07/05/2022 for 15/88 Franklin Street,False,True,1434.0,1434.0,-1434.0,,
212,rps_lng-HDO22146421,2022-04-08T00:00:00+01:00,Payment,Tenant Payment,Tenancy Receipt Ref: 15/88FRANKLINSTREE,True,False,1434.0,1434.0,,,
213,rps_lng-HDO22176458,2022-05-08T00:00:00+01:00,Invoice,Rent,Rent from 08/05/2022 to 07/06/2022 for 15/88 Franklin Street,False,True,1434.0,1434.0,-1434.0,,
214,rps_lng-HDO22191069,2022-05-09T00:00:00+01:00,Payment,Tenant Payment,Tenancy Receipt Ref: 15/88FRANKLINSTREE,True,False,1434.0,1434.0,,,
215,rps_lng-HDO22226043,2022-06-08T00:00:00+01:00,Invoice,Rent,Rent from 08/06/2022 to 07/07/2022 for 15/88 Franklin Street,False,True,1434.0,1434.0,-1434.0,,
216,rps_lng-HDO22235829,2022-06-08T00:00:00+01:00,Payment,Tenant Payment,Tenancy Receipt Ref: 15/88FRANKLINSTREE,True,False,1434.0,1434.0,,,
217,rps_lng-HDO22270168,2022-07-08T00:00:00+01:00,Invoice,Rent,Rent from 08/07/2022 to 07/08/2022 for 15/88 Franklin Street,False,True,1434.0,1434.0,-1434.0,,
218,rps_lng-HDO22284385,2022-07-08T00:00:00+01:00,Payment,Tenant Payment,Tenancy Receipt Ref: 15/88FRANKLINSTREE,True,False,1434.0,1434.0,,,
219,rps_lng-HDO22320670,2022-08-08T00:00:00+01:00,Invoice,Rent,Rent from 08/08/2022 to 07/09/2022 for 15/88 Franklin Street,False,True,1434.0,1434.0,-1434.0,,
220,rps_lng-HDO22330546,2022-08-08T00:00:00+01:00,Payment,Tenant Payment,Tenancy Receipt Ref: 15/88FRANKLINSTREE,True,False,1434.0,1434.0,,,
221,rps_lng-HDO22372210,2022-09-08T00:00:00+01:00,Invoice,Rent,Rent from 08/09/2022 to 07/10/2022 for 15/88 Franklin Street,False,True,1434.0,1434.0,-1434.0,,
222,rps_lng-HDO22387174,2022-09-08T00:00:00+01:00,Payment,Tenant Payment,Tenancy Receipt Ref: 15/88FRANKLINSTREE,True,False,1434.0,1434.0,,,
223,rps_lng-HDO22423373,2022-10-08T00:00:00+01:00,Invoice,Rent,Rent from 08/10/2022 to 07/11/2022 for 15/88 Franklin Street,False,True,1434.0,1434.0,-1434.0,,
224,rps_lng-HDO22439605,2022-10-10T00:00:00+01:00,Payment,Tenant Payment,Tenancy Receipt Ref: 15/88FRANKLINSTREE,True,False,1434.0,1434.0,,,
225,rps_lng-HDO22474134,2022-11-08T00:00:00+00:00,Invoice,Rent,Rent from 08/11/2022 to 07/12/2022 for 15/88 Franklin Street,False,True,1434.0,1434.0,-1434.0,,
226,rps_lng-HDO22485680,2022-11-08T00:00:00+00:00,Payment,Tenant Payment,Tenancy Receipt Ref: 15/88FRANKLINSTREE,True,False,1434.0,1434.0,,,
227,rps_lng-HDO22522451,2022-12-08T00:00:00+00:00,Invoice,Rent,Rent from 08/12/2022 to 07/01/2023 for 15/88 Franklin Street,False,True,1434.0,1434.0,-1434.0,,
228,rps_lng-HDO22532496,2022-12-08T00:00:00+00:00,Payment,Tenant Payment,Tenancy Receipt Ref: 15/88FRANKLINSTREE,True,False,1434.0,1434.0,,,
229,rps_lng-HDO23000154,2023-01-08T00:00:00+00:00,Invoice,Rent,Rent from 08/01/2023 to 07/02/2023 for 15/88 Franklin Street,False,True,1434.0,1434.0,-1434.0,,
230,rps_lng-HDO23015725,2023-01-09T00:00:00+00:00,Payment,Tenant Payment,Tenancy Receipt Ref: 15/88FRANKLINSTREE,True,False,1434.0,1434.0,,,
231,rps_lng-HDO23051737,2023-02-08T00:00:00+00:00,Invoice,Rent,Rent from 08/02/2023 to 07/03/2023 for 15/88 Franklin Street,False,True,1434.0,1434.0,-1434.0,,
232,rps_lng-HDO23061245,2023-02-08T00:00:00+00:00,Payment,Tenant Payment,Tenancy Receipt Ref: 15/88FRANKLINSTREE,True,False,1434.0,1434.0,,,
233,rps_lng-,2021-02-15T00:00:00+00:00,Opening Balance CR,Float,Opening Balance,False,False,,,,,
234,rps_lng-HDO21054898,2021-02-15T00:00:00+00:00,Payment,Tenant Payment,Tenancy Receipt Ref: DEFT Bpay 42354241,True,False,2348.0,2348.0,2348.0,,
235,rps_lng-HDO21055158,2021-02-16T00:00:00+00:00,Invoice,Deposit,Deposit invoice,False,True,1174.0,1174.0,1174.0,,
236,rps_lng-HDO21055159,2021-02-16T00:00:00+00:00,,Deposit,Deposit held,True,False,1174.0,1174.0,2348.0,,
237,rps_lng-HDO21056491,2021-02-17T00:00:00+00:00,Invoice,,Transfer deposit to deposit protection scheme. Ref: 14993742,False,True,1174.0,1174.0,1174.0,,
238,rps_lng-HDO21057949,2021-02-19T00:00:00+00:00,Invoice,Rent,Rent from 19/02/2021 to 18/03/2021 for 15/88 Franklin Street,False,True,1174.0,1174.0,,,
239,rps_lng-HDO21094719,2021-03-16T00:00:00+00:00,Payment,Tenant Payment,Tenancy Receipt Ref: DEFT Bpay 42354241,True,False,1174.0,1174.0,1174.0,,
240,rps_lng-HDO21090464,2021-03-19T00:00:00+00:00,Invoice,Rent,Rent from 19/03/2021 to 18/04/2021 for 15/88 Franklin Street,False,True,1174.0,1174.0,,,
241,rps_lng-HDO21129056,2021-04-19T00:00:00+01:00,Invoice,Rent,Rent from 19/04/2021 to 18/05/2021 for 15/88 Franklin Street,False,True,1174.0,1174.0,-1174.0,,
242,rps_lng-HDO21135173,2021-04-19T00:00:00+01:00,Payment,Tenant Payment,Tenancy Receipt Ref: DEFT Bpay 42354241,True,False,1174.0,1174.0,,,
243,rps_lng-HDO21173836,2021-05-17T00:00:00+01:00,Payment,Tenant Payment,Tenancy Receipt Ref: DEFT Bpay 42354241,True,False,1174.0,1174.0,1174.0,,
244,rps_lng-HDO21169505,2021-05-19T00:00:00+01:00,Invoice,Rent,Rent from 19/05/2021 to 18/06/2021 for 15/88 Franklin Street,False,True,1174.0,1174.0,,,
245,rps_lng-HDO21216729,2021-06-17T00:00:00+01:00,Payment,Tenant Payment,Tenancy Receipt Ref: DEFT Bpay 42354241,True,False,1174.0,1174.0,1174.0,,
246,rps_lng-HDO21210112,2021-06-19T00:00:00+01:00,Invoice,Rent,Rent from 19/06/2021 to 18/07/2021 for 15/88 Franklin Street,False,True,1174.0,1174.0,,,
247,rps_lng-HDO21255618,2021-07-19T00:00:00+01:00,Invoice,Rent,Rent from 19/07/2021 to 18/08/2021 for 15/88 Franklin Street,False,True,1174.0,1174.0,-1174.0,,
248,rps_lng-HDO21262792,2021-07-19T00:00:00+01:00,Payment,Tenant Payment,Tenancy Receipt Ref: DEFT Bpay 42354241,True,False,1174.0,1174.0,,,
249,rps_lng-HDO21302416,2021-08-16T00:00:00+01:00,Payment,Tenant Payment,Tenancy Receipt Ref: DEFT Bpay 42354241,True,False,1174.0,1174.0,1174.0,,
250,rps_lng-HDO21299191,2021-08-19T00:00:00+01:00,Invoice,Rent,Rent from 19/08/2021 to 18/09/2021 for 15/88 Franklin Street,False,True,1174.0,1174.0,,,
251,rps_lng-HDO21351375,2021-09-16T00:00:00+01:00,Invoice,,Water Usage Reimbursement - 13/05/21 - 09/08/21,False,True,104.53,104.53,-104.53,,
252,rps_lng-HDO21346370,2021-09-19T00:00:00+01:00,Invoice,Rent,Rent from 19/09/2021 to 18/10/2021 for 15/88 Franklin Street,False,True,1174.0,1174.0,-1278.53,,
253,rps_lng-HDO21355251,2021-09-20T00:00:00+01:00,Payment,Tenant Payment,Tenancy Receipt Ref: DEFT Bpay 42354241,True,False,1278.53,1278.53,,,
254,rps_lng-HDO21391519,2021-10-13T00:00:00+01:00,Payment,Tenant Payment,Tenancy Receipt Ref: DEFT I/CCd VI 0042354241,True,False,1174.0,1174.0,1174.0,,
255,rps_lng-HDO21391065,2021-10-19T00:00:00+01:00,Invoice,Rent,Rent from 19/10/2021 to 18/11/2021 for 15/88 Franklin Street,False,True,1174.0,1174.0,,,
256,rps_lng-HDO21440679,2021-11-16T00:00:00+00:00,Payment,Tenant Payment,Tenancy Receipt Ref: DEFT Bpay - 42354241 27639,True,False,1174.0,1174.0,1174.0,,
257,rps_lng-HDO21435754,2021-11-19T00:00:00+00:00,Invoice,Rent,Rent from 19/11/2021 to 18/12/2021 for 15/88 Franklin Street,False,True,1174.0,1174.0,,,
258,rps_lng-HDO21479791,2021-12-19T00:00:00+00:00,Invoice,Rent,Rent from 19/12/2021 to 18/01/2022 for 15/88 Franklin Street,False,True,1174.0,1174.0,-1174.0,,
259,rps_lng-HDO21488630,2021-12-20T00:00:00+00:00,Payment,Tenant Payment,Tenancy Receipt Ref: DEFT Bpay - 42354241 45553,True,False,1174.0,1174.0,,,
260,rps_lng-HDO22022400,2022-01-17T00:00:00+00:00,Payment,Tenant Payment,Tenancy Receipt Ref: DEFT Bpay - 42354241 49445,True,False,1174.0,1174.0,1174.0,,
261,rps_lng-HDO22018340,2022-01-19T00:00:00+00:00,Invoice,Rent,Rent from 19/01/2022 to 18/02/2022 for 15/88 Franklin Street,False,True,1174.0,1174.0,,,
262,rps_lng-HDO22067280,2022-02-15T00:00:00+00:00,Payment,Tenant Payment,Tenancy Receipt Ref: DEFT Bpay 42354241,True,False,540.36,540.36,540.36,,
263,rps_lng-HDO22062373,2022-02-19T00:00:00+00:00,Invoice,Rent,Rent from 19/02/2022 to 04/03/2022 for 15/88 Franklin Street,False,True,540.36,540.36,,,
264,rps_lng-HDO22094432,2022-03-03T00:00:00+00:00,Payment,Tenant Payment,Tenancy Receipt Ref: DEFT Bpay 46464111,True,False,2868.0,2868.0,2868.0,,
265,rps_lng-HDO22094716,2022-03-04T00:00:00+00:00,Invoice,Deposit,Deposit invoice,False,True,1434.0,1434.0,1434.0,,
266,rps_lng-HDO22094717,2022-03-04T00:00:00+00:00,,Deposit,Deposit held,True,False,1434.0,1434.0,2868.0,,
267,rps_lng-HDO22098543,2022-03-07T00:00:00+00:00,Invoice,,Transfer deposit to deposit protection scheme. Ref: 15273502,False,True,1434.0,1434.0,1434.0,,
268,rps_lng-HDO22105214,2022-03-08T00:00:00+00:00,Invoice,Rent,Rent from 08/03/2022 to 07/04/2022 for 15/88 Franklin Street,False,True,1434.0,1434.0,,,
269,rps_lng-HDO22133026,2022-04-08T00:00:00+01:00,Invoice,Rent,Rent from 08/04/2022 to 07/05/2022 for 15/88 Franklin Street,False,True,1434.0,1434.0,-1434.0,,
270,rps_lng-HDO22146421,2022-04-08T00:00:00+01:00,Payment,Tenant Payment,Tenancy Receipt Ref: 15/88FRANKLINSTREE,True,False,1434.0,1434.0,,,
271,rps_lng-HDO22176458,2022-05-08T00:00:00+01:00,Invoice,Rent,Rent from 08/05/2022 to 07/06/2022 for 15/88 Franklin Street,False,True,1434.0,1434.0,-1434.0,,
272,rps_lng-HDO22191069,2022-05-09T00:00:00+01:00,Payment,Tenant Payment,Tenancy Receipt Ref: 15/88FRANKLINSTREE,True,False,1434.0,1434.0,,,
273,rps_lng-HDO22226043,2022-06-08T00:00:00+01:00,Invoice,Rent,Rent from 08/06/2022 to 07/07/2022 for 15/88 Franklin Street,False,True,1434.0,1434.0,-1434.0,,
274,rps_lng-HDO22235829,2022-06-08T00:00:00+01:00,Payment,Tenant Payment,Tenancy Receipt Ref: 15/88FRANKLINSTREE,True,False,1434.0,1434.0,,,
275,rps_lng-HDO22270168,2022-07-08T00:00:00+01:00,Invoice,Rent,Rent from 08/07/2022 to 07/08/2022 for 15/88 Franklin Street,False,True,1434.0,1434.0,-1434.0,,
276,rps_lng-HDO22284385,2022-07-08T00:00:00+01:00,Payment,Tenant Payment,Tenancy Receipt Ref: 15/88FRANKLINSTREE,True,False,1434.0,1434.0,,,
277,rps_lng-HDO22320670,2022-08-08T00:00:00+01:00,Invoice,Rent,Rent from 08/08/2022 to 07/09/2022 for 15/88 Franklin Street,False,True,1434.0,1434.0,-1434.0,,
278,rps_lng-HDO22330546,2022-08-08T00:00:00+01:00,Payment,Tenant Payment,Tenancy Receipt Ref: 15/88FRANKLINSTREE,True,False,1434.0,1434.0,,,
279,rps_lng-HDO22372210,2022-09-08T00:00:00+01:00,Invoice,Rent,Rent from 08/09/2022 to 07/10/2022 for 15/88 Franklin Street,False,True,1434.0,1434.0,-1434.0,,
280,rps_lng-HDO22387174,2022-09-08T00:00:00+01:00,Payment,Tenant Payment,Tenancy Receipt Ref: 15/88FRANKLINSTREE,True,False,1434.0,1434.0,,,
281,rps_lng-HDO22423373,2022-10-08T00:00:00+01:00,Invoice,Rent,Rent from 08/10/2022 to 07/11/2022 for 15/88 Franklin Street,False,True,1434.0,1434.0,-1434.0,,
282,rps_lng-HDO22439605,2022-10-10T00:00:00+01:00,Payment,Tenant Payment,Tenancy Receipt Ref: 15/88FRANKLINSTREE,True,False,1434.0,1434.0,,,
283,rps_lng-HDO22474134,2022-11-08T00:00:00+00:00,Invoice,Rent,Rent from 08/11/2022 to 07/12/2022 for 15/88 Franklin Street,False,True,1434.0,1434.0,-1434.0,,
284,rps_lng-HDO22485680,2022-11-08T00:00:00+00:00,Payment,Tenant Payment,Tenancy Receipt Ref: 15/88FRANKLINSTREE,True,False,1434.0,1434.0,,,
285,rps_lng-HDO22522451,2022-12-08T00:00:00+00:00,Invoice,Rent,Rent from 08/12/2022 to 07/01/2023 for 15/88 Franklin Street,False,True,1434.0,1434.0,-1434.0,,
286,rps_lng-HDO22532496,2022-12-08T00:00:00+00:00,Payment,Tenant Payment,Tenancy Receipt Ref: 15/88FRANKLINSTREE,True,False,1434.0,1434.0,,,
287,rps_lng-HDO23000154,2023-01-08T00:00:00+00:00,Invoice,Rent,Rent from 08/01/2023 to 07/02/2023 for 15/88 Franklin Street,False,True,1434.0,1434.0,-1434.0,,
288,rps_lng-HDO23015725,2023-01-09T00:00:00+00:00,Payment,Tenant Payment,Tenancy Receipt Ref: 15/88FRANKLINSTREE,True,False,1434.0,1434.0,,,
289,rps_lng-HDO23051737,2023-02-08T00:00:00+00:00,Invoice,Rent,Rent from 08/02/2023 to 07/03/2023 for 15/88 Franklin Street,False,True,1434.0,1434.0,-1434.0,,
290,rps_lng-HDO23061245,2023-02-08T00:00:00+00:00,Payment,Tenant Payment,Tenancy Receipt Ref: 15/88FRANKLINSTREE,True,False,1434.0,1434.0,,,
291,rps_lng-,2021-02-01T00:00:00+00:00,Opening Balance CR,Float,Opening Balance,False,False,,,,,
292,rps_lng-HDO21036712,2021-02-01T00:00:00+00:00,Payment,Tenant Payment,Tenancy Receipt Ref: OC1213381,True,False,2781.0,2781.0,2781.0,,
293,rps_lng-HDO21032765,2021-02-01T00:00:00+00:00,Invoice,Rent,Rent from 01/02/2021 to 28/02/2021 for 904/1 Roy Street,False,True,2781.0,2781.0,,,
294,rps_lng-HDO21038641,2021-02-03T00:00:00+00:00,Debit Adjustment,Tenant Payment,Dishonoured Direct Debit: Tenancy Receipt Ref: OC1213381,False,True,2781.0,2781.0,-2781.0,,
295,rps_lng-HDO21039800,2021-02-03T00:00:00+00:00,Payment,Tenant Payment,Tenancy Receipt Ref: DEFT Bpay 25427899,True,False,2781.0,2781.0,,,
296,rps_lng-HDO21064649,2021-03-01T00:00:00+00:00,Invoice,Rent,Rent from 01/03/2021 to 31/03/2021 for 904/1 Roy Street,False,True,2781.0,2781.0,-2781.0,,
297,rps_lng-HDO21075351,2021-03-01T00:00:00+00:00,Payment,Tenant Payment,Tenancy Receipt Ref: OC1213381,True,False,2781.0,2781.0,,,
298,rps_lng-HDO21105418,2021-04-01T00:00:00+01:00,Invoice,Rent,Rent from 01/04/2021 to 30/04/2021 for 904/1 Roy Street,False,True,2781.0,2781.0,-2781.0,,
299,rps_lng-HDO21116628,2021-04-01T00:00:00+01:00,Payment,Tenant Payment,Tenancy Receipt Ref: OC1213381,True,False,2781.0,2781.0,,,
300,rps_lng-HDO21140729,2021-05-01T00:00:00+01:00,Invoice,Rent,Rent from 01/05/2021 to 31/05/2021 for 904/1 Roy Street,False,True,2781.0,2781.0,-2781.0,,
301,rps_lng-HDO21155795,2021-05-03T00:00:00+01:00,Payment,Tenant Payment,Tenancy Receipt Ref: OC1213381,True,False,2781.0,2781.0,,,
302,rps_lng-HDO21184477,2021-06-01T00:00:00+01:00,Invoice,Rent,Rent from 01/06/2021 to 30/06/2021 for 904/1 Roy Street,False,True,2781.0,2781.0,-2781.0,,
303,rps_lng-HDO21194699,2021-06-01T00:00:00+01:00,Payment,Tenant Payment,Tenancy Receipt Ref: OC1213381,True,False,2781.0,2781.0,,,
304,rps_lng-HDO21226357,2021-07-01T00:00:00+01:00,Invoice,Rent,Rent from 01/07/2021 to 31/07/2021 for 904/1 Roy Street,False,True,2781.0,2781.0,-2781.0,,
305,rps_lng-HDO21237731,2021-07-01T00:00:00+01:00,Payment,Tenant Payment,Tenancy Receipt Ref: OC1213381,True,False,2781.0,2781.0,,,
306,rps_lng-HDO21271916,2021-08-01T00:00:00+01:00,Invoice,Rent,Rent from 01/08/2021 to 31/08/2021 for 904/1 Roy Street,False,True,2781.0,2781.0,-2781.0,,
307,rps_lng-HDO21282510,2021-08-02T00:00:00+01:00,Payment,Tenant Payment,Tenancy Receipt Ref: OC1213381,True,False,2781.0,2781.0,,,
308,rps_lng-HDO21316235,2021-09-01T00:00:00+01:00,Invoice,Rent,Rent from 01/09/2021 to 30/09/2021 for 904/1 Roy Street,False,True,2781.0,2781.0,-2781.0,,
309,rps_lng-HDO21329162,2021-09-01T00:00:00+01:00,Payment,Tenant Payment,Tenancy Receipt Ref: OC1213381,True,False,2781.0,2781.0,,,
310,rps_lng-HDO21361143,2021-10-01T00:00:00+01:00,Invoice,Rent,Rent from 01/10/2021 to 31/10/2021 for 904/1 Roy Street,False,True,2781.0,2781.0,-2781.0,,
311,rps_lng-HDO21374952,2021-10-01T00:00:00+01:00,Payment,Tenant Payment,Tenancy Receipt Ref: OC1213381,True,False,2781.0,2781.0,,,
312,rps_lng-HDO21407357,2021-11-01T00:00:00+00:00,Invoice,Rent,Rent from 01/11/2021 to 30/11/2021 for 904/1 Roy Street,False,True,2781.0,2781.0,-2781.0,,
313,rps_lng-HDO21419872,2021-11-01T00:00:00+00:00,Payment,Tenant Payment,Tenancy Receipt Ref: OC1213381,True,False,2781.0,2781.0,,,
314,rps_lng-HDO21451652,2021-12-01T00:00:00+00:00,Invoice,Rent,Rent from 01/12/2021 to 31/12/2021 for 904/1 Roy Street,False,True,2781.0,2781.0,-2781.0,,
315,rps_lng-HDO21462850,2021-12-01T00:00:00+00:00,Payment,Tenant Payment,Tenancy Receipt Ref: OC1213381,True,False,2781.0,2781.0,,,
316,rps_lng-HDO21494264,2022-01-01T00:00:00+00:00,Invoice,Rent,Rent from 01/01/2022 to 31/01/2022 for 904/1 Roy Street,False,True,2781.0,2781.0,-2781.0,,
317,rps_lng-HDO22005039,2022-01-04T00:00:00+00:00,Payment,Tenant Payment,Tenancy Receipt Ref: OC1213381,True,False,2781.0,2781.0,,,
318,rps_lng-HDO22034165,2022-02-01T00:00:00+00:00,Invoice,Rent,Rent from 01/02/2022 to 28/02/2022 for 904/1 Roy Street,False,True,2781.0,2781.0,-2781.0,,
319,rps_lng-HDO22046722,2022-02-01T00:00:00+00:00,Payment,Tenant Payment,Tenancy Receipt Ref: OC1213381,True,False,2781.0,2781.0,,,
320,rps_lng-HDO22078827,2022-03-01T00:00:00+00:00,Invoice,Rent,Rent from 01/03/2022 to 31/03/2022 for 904/1 Roy Street,False,True,2781.0,2781.0,-2781.0,,
321,rps_lng-HDO22090653,2022-03-01T00:00:00+00:00,Payment,Tenant Payment,Tenancy Receipt Ref: OC1213381,True,False,2781.0,2781.0,,,
322,rps_lng-HDO22123044,2022-04-01T00:00:00+01:00,Invoice,Rent,Rent from 01/04/2022 to 30/04/2022 for 904/1 Roy Street,False,True,2781.0,2781.0,-2781.0,,
323,rps_lng-HDO22135232,2022-04-01T00:00:00+01:00,Payment,Tenant Payment,Tenancy Receipt Ref: OC1213381,True,False,2781.0,2781.0,,,
324,rps_lng-HDO22162291,2022-05-01T00:00:00+01:00,Invoice,Rent,Rent from 01/05/2022 to 31/05/2022 for 904/1 Roy Street,False,True,2781.0,2781.0,-2781.0,,
325,rps_lng-HDO22178189,2022-05-02T00:00:00+01:00,Payment,Tenant Payment,Tenancy Receipt Ref: OC1213381,True,False,2781.0,2781.0,,,
326,rps_lng-HDO22213603,2022-06-01T00:00:00+01:00,Invoice,Rent,Rent from 01/06/2022 to 30/06/2022 for 904/1 Roy Street,False,True,2781.0,2781.0,-2781.0,,
327,rps_lng-HDO22224361,2022-06-01T00:00:00+01:00,Payment,Tenant Payment,Tenancy Receipt Ref: OC1213381,True,False,2781.0,2781.0,,,
328,rps_lng-HDO22256805,2022-07-01T00:00:00+01:00,Invoice,Rent,Rent from 01/07/2022 to 31/07/2022 for 904/1 Roy Street,False,True,2781.0,2781.0,-2781.0,,
329,rps_lng-HDO22272442,2022-07-01T00:00:00+01:00,Payment,Tenant Payment,Tenancy Receipt Ref: OC1213381,True,False,2781.0,2781.0,,,
330,rps_lng-HDO22308732,2022-08-01T00:00:00+01:00,Invoice,Rent,Rent from 01/08/2022 to 31/08/2022 for 904/1 Roy Street,False,True,2781.0,2781.0,-2781.0,,
331,rps_lng-HDO22319125,2022-08-01T00:00:00+01:00,Payment,Tenant Payment,Tenancy Receipt Ref: OC1213381,True,False,2781.0,2781.0,,,
332,rps_lng-HDO22358308,2022-09-01T00:00:00+01:00,Invoice,Rent,Rent from 01/09/2022 to 30/09/2022 for 904/1 Roy Street,False,True,2781.0,2781.0,-2781.0,,
333,rps_lng-HDO22370632,2022-09-01T00:00:00+01:00,Payment,Tenant Payment,Tenancy Receipt Ref: OC1213381,True,False,2781.0,2781.0,,,
334,rps_lng-HDO22410463,2022-10-01T00:00:00+01:00,Invoice,Rent,Rent from 01/10/2022 to 31/10/2022 for 904/1 Roy Street,False,True,2781.0,2781.0,-2781.0,,
335,rps_lng-HDO22427602,2022-10-03T00:00:00+01:00,Payment,Tenant Payment,Tenancy Receipt Ref: OC1213381,True,False,2781.0,2781.0,,,
336,rps_lng-HDO22461324,2022-11-01T00:00:00+00:00,Invoice,Rent,Rent from 01/11/2022 to 30/11/2022 for 904/1 Roy Street,False,True,2781.0,2781.0,-2781.0,,
337,rps_lng-HDO22475486,2022-11-02T00:00:00+00:00,Payment,Tenant Payment,Tenancy Receipt Ref: OC1213381,True,False,2781.0,2781.0,,,
338,rps_lng-HDO22510220,2022-12-01T00:00:00+00:00,Invoice,Rent,Rent from 01/12/2022 to 31/12/2022 for 904/1 Roy Street,False,True,2781.0,2781.0,-2781.0,,
339,rps_lng-HDO22521132,2022-12-01T00:00:00+00:00,Payment,Tenant Payment,Tenancy Receipt Ref: OC1213381,True,False,2781.0,2781.0,,,
340,rps_lng-HDO22553265,2023-01-01T00:00:00+00:00,Invoice,Rent,Rent from 01/01/2023 to 31/01/2023 for 904/1 Roy Street,False,True,2781.0,2781.0,-2781.0,,
341,rps_lng-HDO23005249,2023-01-03T00:00:00+00:00,Payment,Tenant Payment,Tenancy Receipt Ref: OC1213381,True,False,2781.0,2781.0,,,
342,rps_lng-HDO23038945,2023-02-01T00:00:00+00:00,Invoice,Rent,Rent from 01/02/2023 to 28/02/2023 for 904/1 Roy Street,False,True,2781.0,2781.0,-2781.0,,
343,rps_lng-HDO23050205,2023-02-01T00:00:00+00:00,Payment,Tenant Payment,Tenancy Receipt Ref: OC1213381,True,False,2781.0,2781.0,,,
344,rps_lng-HDO23084324,2023-03-01T00:00:00+00:00,Invoice,Rent,Rent from 01/03/2023 to 31/03/2023 for 904/1 Roy Street,False,True,2781.0,2781.0,-2781.0,,
345,rps_lng-HDO23096236,2023-03-01T00:00:00+00:00,Payment,Tenant Payment,Tenancy Receipt Ref: OC1213381,True,False,2781.0,2781.0,,,
346,rps_lng-HDO23131311,2023-04-01T00:00:00+01:00,Invoice,Rent,Rent from 01/04/2023 to 30/04/2023 for 904/1 Roy Street,False,True,2781.0,2781.0,-2781.0,,
347,rps_lng-HDO23146442,2023-04-03T00:00:00+01:00,Payment,Tenant Payment,Tenancy Receipt Ref: OC1213381,True,False,2781.0,2781.0,,,
348,rps_lng-HDO23176775,2023-05-01T00:00:00+01:00,Invoice,Rent,Rent from 01/05/2023 to 31/05/2023 for 904/1 Roy Street,False,True,2781.0,2781.0,-2781.0,,
349,rps_lng-HDO23190834,2023-05-01T00:00:00+01:00,Payment,Tenant Payment,Tenancy Receipt Ref: OC1213381,True,False,2781.0,2781.0,,,
350,rps_lng-HDO23228051,2023-06-01T00:00:00+01:00,Invoice,Rent,Rent from 01/06/2023 to 30/06/2023 for 904/1 Roy Street,False,True,2781.0,2781.0,-2781.0,,
351,rps_lng-HDO23238426,2023-06-01T00:00:00+01:00,Payment,Tenant Payment,Tenancy Receipt Ref: OC1213381,True,False,2781.0,2781.0,,,
352,rps_lng-HDO23272525,2023-07-01T00:00:00+01:00,Invoice,Rent,Rent from 01/07/2023 to 31/07/2023 for 904/1 Roy Street,False,True,2781.0,2781.0,-2781.0,,
353,rps_lng-HDO23288264,2023-07-03T00:00:00+01:00,Payment,Tenant Payment,Tenancy Receipt Ref: OC1213381,True,False,2781.0,2781.0,,,
354,rps_lng-HDO23325659,2023-08-01T00:00:00+01:00,Invoice,Rent,Rent from 01/08/2023 to 31/08/2023 for 904/1 Roy Street,False,True,2781.0,2781.0,-2781.0,,
355,rps_lng-HDO23337205,2023-08-01T00:00:00+01:00,Payment,Tenant Payment,Tenancy Receipt Ref: OC1213381,True,False,2781.0,2781.0,,,
356,rps_lng-,2022-03-11T00:00:00+00:00,Opening Balance CR,Float,Opening Balance,False,False,,,,,
357,rps_lng-HDO22107860,2022-03-11T00:00:00+00:00,Payment,Tenant Payment,Tenancy Receipt Ref: DEFT Bpay 46464541,True,False,2868.0,2868.0,2868.0,,
358,rps_lng-HDO22110518,2022-03-16T00:00:00+00:00,Invoice,Deposit,Deposit invoice,False,True,1434.0,1434.0,1434.0,,
359,rps_lng-HDO22110519,2022-03-16T00:00:00+00:00,,Deposit,Deposit held,True,False,1434.0,1434.0,2868.0,,
360,rps_lng-HDO22128738,2022-03-21T00:00:00+00:00,Invoice,Rent,Rent from 21/03/2022 to 20/04/2022 for 33/88 Franklin Street,False,True,1434.0,1434.0,1434.0,,
361,rps_lng-HDO22119996,2022-03-23T00:00:00+00:00,Invoice,,Transfer deposit to deposit protection scheme. Ref: 15286610,False,True,1434.0,1434.0,,,
362,rps_lng-HDO22160665,2022-04-21T00:00:00+01:00,Payment,Tenant Payment,Tenancy Receipt Ref: 33/88FRANKLINSTREE,True,False,1434.0,1434.0,1434.0,,
363,rps_lng-HDO22153549,2022-04-21T00:00:00+01:00,Invoice,Rent,Rent from 21/04/2022 to 20/05/2022 for 33/88 Franklin Street,False,True,1434.0,1434.0,,,
364,rps_lng-HDO22166560,2022-04-26T00:00:00+01:00,Debit Adjustment,Tenant Payment,Dishonoured Direct Debit: Tenancy Receipt Ref: 33/88FRANKLINSTREE,False,True,1434.0,1434.0,-1434.0,,
365,rps_lng-HDO22166561,2022-04-26T00:00:00+01:00,Invoice,Tenant Admin Fee,Dishonour Fee,False,True,25.0,25.0,-1459.0,,
366,rps_lng-HDO22173886,2022-04-29T00:00:00+01:00,Payment,Tenant Payment,Tenancy Receipt Ref: DEFT Bpay 46464541,True,False,1459.0,1459.0,,,
367,rps_lng-HDO22196712,2022-05-21T00:00:00+01:00,Invoice,Rent,Rent from 21/05/2022 to 20/06/2022 for 33/88 Franklin Street,False,True,1434.0,1434.0,-1434.0,,
368,rps_lng-HDO22209063,2022-05-23T00:00:00+01:00,Payment,Tenant Payment,Tenancy Receipt Ref: DEFT Bpay 46464541,True,False,1434.0,1434.0,,,
369,rps_lng-HDO22209386,2022-05-23T00:00:00+01:00,Payment,Tenant Payment,Tenancy Receipt Ref: 33/88FRANKLINSTREE,True,False,1434.0,1434.0,1434.0,,
370,rps_lng-HDO22211033,2022-05-25T00:00:00+01:00,Debit Adjustment,Tenant Payment,Dishonoured Direct Debit: Tenancy Receipt Ref: 33/88FRANKLINSTREE,False,True,1434.0,1434.0,,,
371,rps_lng-HDO22243671,2022-06-21T00:00:00+01:00,Invoice,Rent,Rent from 21/06/2022 to 20/07/2022 for 33/88 Franklin Street,False,True,1434.0,1434.0,-1434.0,,
372,rps_lng-HDO22251709,2022-06-21T00:00:00+01:00,Payment,Tenant Payment,Tenancy Receipt Ref: DEFT Bpay 46464541,True,False,1434.0,1434.0,,,
373,rps_lng-HDO22251847,2022-06-21T00:00:00+01:00,Payment,Tenant Payment,Tenancy Receipt Ref: 33/88FRANKLINSTREE,True,False,1434.0,1434.0,1434.0,,
374,rps_lng-HDO22254051,2022-06-23T00:00:00+01:00,Debit Adjustment,Tenant Payment,Dishonoured Direct Debit: Tenancy Receipt Ref: 33/88FRANKLINSTREE,False,True,1434.0,1434.0,,,
375,rps_lng-HDO22302779,2022-07-21T00:00:00+01:00,Payment,Tenant Payment,Tenancy Receipt Ref: 33/88FRANKLINSTREE,True,False,1434.0,1434.0,1434.0,,
376,rps_lng-HDO22292812,2022-07-21T00:00:00+01:00,Invoice,Rent,Rent from 21/07/2022 to 20/08/2022 for 33/88 Franklin Street,False,True,1434.0,1434.0,,,
377,rps_lng-HDO22305512,2022-07-22T00:00:00+01:00,Payment,Tenant Payment,Tenancy Receipt Ref: DEFT Bpay 46464541,True,False,1434.0,1434.0,1434.0,,
378,rps_lng-HDO22305747,2022-07-25T00:00:00+01:00,Debit Adjustment,Tenant Payment,Dishonoured Direct Debit: Tenancy Receipt Ref: 33/88FRANKLINSTREE,False,True,1434.0,1434.0,,,
379,rps_lng-HDO22341457,2022-08-21T00:00:00+01:00,Invoice,Rent,Rent from 21/08/2022 to 20/09/2022 for 33/88 Franklin Street,False,True,1434.0,1434.0,-1434.0,,
380,rps_lng-HDO22351651,2022-08-22T00:00:00+01:00,Payment,Tenant Payment,Tenancy Receipt Ref: DEFT Bpay 46464541,True,False,1434.0,1434.0,,,
381,rps_lng-HDO22352078,2022-08-22T00:00:00+01:00,Payment,Tenant Payment,Tenancy Receipt Ref: 33/88FRANKLINSTREE,True,False,1434.0,1434.0,1434.0,,
382,rps_lng-HDO22353966,2022-08-24T00:00:00+01:00,Debit Adjustment,Tenant Payment,Dishonoured Direct Debit: Tenancy Receipt Ref: 33/88FRANKLINSTREE,False,True,1434.0,1434.0,,,
383,rps_lng-HDO22400401,2022-09-21T00:00:00+01:00,Invoice,Rent,Rent from 21/09/2022 to 20/10/2022 for 33/88 Franklin Street,False,True,1434.0,1434.0,-1434.0,,
384,rps_lng-HDO22409888,2022-09-21T00:00:00+01:00,Payment,Tenant Payment,Tenancy Receipt Ref: DEFT Bpay 46464541,True,False,1434.0,1434.0,,,
385,rps_lng-HDO22410052,2022-09-21T00:00:00+01:00,Payment,Tenant Payment,Tenancy Receipt Ref: 33/88FRANKLINSTREE,True,False,1434.0,1434.0,1434.0,,
386,rps_lng-HDO22413431,2022-09-26T00:00:00+01:00,Debit Adjustment,Tenant Payment,Dishonoured Direct Debit: Tenancy Receipt Ref: 33/88FRANKLINSTREE,False,True,1434.0,1434.0,,,
387,rps_lng-HDO22446096,2022-10-21T00:00:00+01:00,Invoice,Rent,Rent from 21/10/2022 to 20/11/2022 for 33/88 Franklin Street,False,True,1434.0,1434.0,-1434.0,,
388,rps_lng-HDO22458420,2022-10-24T00:00:00+01:00,Payment,Tenant Payment,Tenancy Receipt Ref: DEFT Bpay 46464541,True,False,1434.0,1434.0,,,
389,rps_lng-HDO22458741,2022-10-24T00:00:00+01:00,Payment,Tenant Payment,Tenancy Receipt Ref: 33/88FRANKLINSTREE,True,False,1434.0,1434.0,1434.0,,
390,rps_lng-HDO22460502,2022-10-26T00:00:00+01:00,Debit Adjustment,Tenant Payment,Dishonoured Direct Debit: Tenancy Receipt Ref: 33/88FRANKLINSTREE,False,True,1434.0,1434.0,,,
391,rps_lng-HDO22495166,2022-11-21T00:00:00+00:00,Invoice,Rent,Rent from 21/11/2022 to 20/12/2022 for 33/88 Franklin Street,False,True,1434.0,1434.0,-1434.0,,
392,rps_lng-HDO22505442,2022-11-22T00:00:00+00:00,Payment,Tenant Payment,Tenancy Receipt Ref: DEFT Bpay 46464541,True,False,1434.0,1434.0,,,
393,rps_lng-HDO22505752,2022-11-22T00:00:00+00:00,Payment,Tenant Payment,Tenancy Receipt Ref: 33/88FRANKLINSTREE,True,False,1434.0,1434.0,1434.0,,
394,rps_lng-HDO22507349,2022-11-24T00:00:00+00:00,Debit Adjustment,Tenant Payment,Dishonoured Direct Debit: Tenancy Receipt Ref: 33/88FRANKLINSTREE,False,True,1434.0,1434.0,,,
395,rps_lng-HDO22548167,2022-12-20T00:00:00+00:00,Payment,Tenant Payment,Tenancy Receipt Ref: DEFT Bpay 46464541,True,False,1434.0,1434.0,1434.0,,
396,rps_lng-HDO22541764,2022-12-21T00:00:00+00:00,Invoice,Rent,Rent from 21/12/2022 to 20/01/2023 for 33/88 Franklin Street,False,True,1434.0,1434.0,,,
397,rps_lng-HDO23025517,2023-01-16T00:00:00+00:00,Payment,Tenant Payment,Tenancy Receipt Ref: 33/88FRANKLINSTREE,True,False,1434.0,1434.0,1434.0,,
398,rps_lng-HDO23027032,2023-01-18T00:00:00+00:00,Debit Adjustment,Tenant Payment,Dishonoured Direct Debit: Tenancy Receipt Ref: 33/88FRANKLINSTREE,False,True,1434.0,1434.0,,,
399,rps_lng-HDO23021799,2023-01-21T00:00:00+00:00,Invoice,Rent,Rent from 21/01/2023 to 20/02/2023 for 33/88 Franklin Street,False,True,1434.0,1434.0,-1434.0,,
400,rps_lng-HDO23036138,2023-01-23T00:00:00+00:00,Payment,Tenant Payment,Tenancy Receipt Ref: DEFT Bpay 46464541,True,False,1434.0,1434.0,,,
401,rps_lng-HDO23036470,2023-01-23T00:00:00+00:00,Payment,Tenant Payment,Tenancy Receipt Ref: 33/88FRANKLINSTREE,True,False,1434.0,1434.0,1434.0,,
402,rps_lng-HDO23038058,2023-01-25T00:00:00+00:00,Debit Adjustment,Tenant Payment,Dishonoured Direct Debit: Tenancy Receipt Ref: 33/88FRANKLINSTREE,False,True,1434.0,1434.0,,,
403,rps_lng-HDO23079933,2023-02-21T00:00:00+00:00,Payment,Tenant Payment,Tenancy Receipt Ref: 33/88FRANKLINSTREE,True,False,1434.0,1434.0,1434.0,,
404,rps_lng-HDO23070147,2023-02-21T00:00:00+00:00,Invoice,Rent,Rent from 21/02/2023 to 20/03/2023 for 33/88 Franklin Street,False,True,1434.0,1434.0,,,
405,rps_lng-HDO23082470,2023-02-22T00:00:00+00:00,Payment,Tenant Payment,Tenancy Receipt Ref: DEFT Bpay 46464541,True,False,1434.0,1434.0,1434.0,,
406,rps_lng-HDO23082688,2023-02-23T00:00:00+00:00,Debit Adjustment,Tenant Payment,Dishonoured Direct Debit: Tenancy Receipt Ref: 33/88FRANKLINSTREE,False,True,1434.0,1434.0,,,
407,rps_lng-HDO23117524,2023-03-21T00:00:00+00:00,Invoice,Rent,Rent from 21/03/2023 to 20/04/2023 for 33/88 Franklin Street,False,True,1521.0,1521.0,-1521.0,,
408,rps_lng-HDO23126240,2023-03-21T00:00:00+00:00,Payment,Tenant Payment,Tenancy Receipt Ref: DEFT Bpay 46464541,True,False,1521.0,1521.0,,,
409,rps_lng-HDO23126388,2023-03-21T00:00:00+00:00,Payment,Tenant Payment,Tenancy Receipt Ref: 33/88FRANKLINSTREE,True,False,1521.0,1521.0,1521.0,,
410,rps_lng-HDO23128724,2023-03-23T00:00:00+00:00,Debit Adjustment,Tenant Payment,Dishonoured Direct Debit: Tenancy Receipt Ref: 33/88FRANKLINSTREE,False,True,1521.0,1521.0,,,
411,rps_lng-HDO23170724,2023-04-19T00:00:00+01:00,Payment,Tenant Payment,Tenancy Receipt Ref: DEFT Bpay 46464541,True,False,1521.0,1521.0,1521.0,,
412,rps_lng-HDO23163275,2023-04-21T00:00:00+01:00,Invoice,Rent,Rent from 21/04/2023 to 20/05/2023 for 33/88 Franklin Street,False,True,1521.0,1521.0,,,
413,rps_lng-HDO23211118,2023-05-21T00:00:00+01:00,Invoice,Rent,Rent from 21/05/2023 to 20/06/2023 for 33/88 Franklin Street,False,True,1521.0,1521.0,-1521.0,,
414,rps_lng-HDO23222139,2023-05-22T00:00:00+01:00,Payment,Tenant Payment,Tenancy Receipt Ref: DEFT Bpay 46464541,True,False,1521.0,1521.0,,,
415,rps_lng-HDO23222486,2023-05-22T00:00:00+01:00,Payment,Tenant Payment,Tenancy Receipt Ref: 33/88FRANKLINSTREE,True,False,1521.0,1521.0,1521.0,,
416,rps_lng-HDO23224462,2023-05-24T00:00:00+01:00,Debit Adjustment,Tenant Payment,Dishonoured Direct Debit: Tenancy Receipt Ref: 33/88FRANKLINSTREE,False,True,1521.0,1521.0,,,
417,rps_lng-HDO23258103,2023-06-21T00:00:00+01:00,Invoice,Rent,Rent from 21/06/2023 to 20/07/2023 for 33/88 Franklin Street,False,True,1521.0,1521.0,-1521.0,,
418,rps_lng-HDO23267894,2023-06-21T00:00:00+01:00,Payment,Tenant Payment,Tenancy Receipt Ref: DEFT Bpay 46464541,True,False,1521.0,1521.0,,,
419,rps_lng-HDO23268090,2023-06-21T00:00:00+01:00,Payment,Tenant Payment,Tenancy Receipt Ref: 33/88FRANKLINSTREE,True,False,1521.0,1521.0,1521.0,,
420,rps_lng-HDO23270908,2023-06-23T00:00:00+01:00,Debit Adjustment,Tenant Payment,Dishonoured Direct Debit: Tenancy Receipt Ref: 33/88FRANKLINSTREE,False,True,1521.0,1521.0,,,
421,rps_lng-HDO23304541,2023-07-11T00:00:00+01:00,Payment,Tenant Payment,Tenancy Receipt Ref: DEFT Bpay 46464541,True,False,1521.0,1521.0,1521.0,,
422,rps_lng-HDO23309138,2023-07-21T00:00:00+01:00,Invoice,Rent,Rent from 21/07/2023 to 20/08/2023 for 33/88 Franklin Street,False,True,1521.0,1521.0,,,
423,rps_lng-HDO23336500,2023-08-01T00:00:00+01:00,Payment,Tenant Payment,Tenancy Receipt Ref: DEFT Bpay 46464541,True,False,1521.0,1521.0,1521.0,1521.0,
424,rps_lng-,2022-03-11T00:00:00+00:00,Opening Balance CR,Float,Opening Balance,False,False,,,,,
425,rps_lng-HDO22107860,2022-03-11T00:00:00+00:00,Payment,Tenant Payment,Tenancy Receipt Ref: DEFT Bpay 46464541,True,False,2868.0,2868.0,2868.0,,
426,rps_lng-HDO22110518,2022-03-16T00:00:00+00:00,Invoice,Deposit,Deposit invoice,False,True,1434.0,1434.0,1434.0,,
427,rps_lng-HDO22110519,2022-03-16T00:00:00+00:00,,Deposit,Deposit held,True,False,1434.0,1434.0,2868.0,,
428,rps_lng-HDO22128738,2022-03-21T00:00:00+00:00,Invoice,Rent,Rent from 21/03/2022 to 20/04/2022 for 33/88 Franklin Street,False,True,1434.0,1434.0,1434.0,,
429,rps_lng-HDO22119996,2022-03-23T00:00:00+00:00,Invoice,,Transfer deposit to deposit protection scheme. Ref: 15286610,False,True,1434.0,1434.0,,,
430,rps_lng-HDO22160665,2022-04-21T00:00:00+01:00,Payment,Tenant Payment,Tenancy Receipt Ref: 33/88FRANKLINSTREE,True,False,1434.0,1434.0,1434.0,,
431,rps_lng-HDO22153549,2022-04-21T00:00:00+01:00,Invoice,Rent,Rent from 21/04/2022 to 20/05/2022 for 33/88 Franklin Street,False,True,1434.0,1434.0,,,
432,rps_lng-HDO22166560,2022-04-26T00:00:00+01:00,Debit Adjustment,Tenant Payment,Dishonoured Direct Debit: Tenancy Receipt Ref: 33/88FRANKLINSTREE,False,True,1434.0,1434.0,-1434.0,,
433,rps_lng-HDO22166561,2022-04-26T00:00:00+01:00,Invoice,Tenant Admin Fee,Dishonour Fee,False,True,25.0,25.0,-1459.0,,
434,rps_lng-HDO22173886,2022-04-29T00:00:00+01:00,Payment,Tenant Payment,Tenancy Receipt Ref: DEFT Bpay 46464541,True,False,1459.0,1459.0,,,
435,rps_lng-HDO22196712,2022-05-21T00:00:00+01:00,Invoice,Rent,Rent from 21/05/2022 to 20/06/2022 for 33/88 Franklin Street,False,True,1434.0,1434.0,-1434.0,,
436,rps_lng-HDO22209063,2022-05-23T00:00:00+01:00,Payment,Tenant Payment,Tenancy Receipt Ref: DEFT Bpay 46464541,True,False,1434.0,1434.0,,,
437,rps_lng-HDO22209386,2022-05-23T00:00:00+01:00,Payment,Tenant Payment,Tenancy Receipt Ref: 33/88FRANKLINSTREE,True,False,1434.0,1434.0,1434.0,,
438,rps_lng-HDO22211033,2022-05-25T00:00:00+01:00,Debit Adjustment,Tenant Payment,Dishonoured Direct Debit: Tenancy Receipt Ref: 33/88FRANKLINSTREE,False,True,1434.0,1434.0,,,
439,rps_lng-HDO22243671,2022-06-21T00:00:00+01:00,Invoice,Rent,Rent from 21/06/2022 to 20/07/2022 for 33/88 Franklin Street,False,True,1434.0,1434.0,-1434.0,,
440,rps_lng-HDO22251709,2022-06-21T00:00:00+01:00,Payment,Tenant Payment,Tenancy Receipt Ref: DEFT Bpay 46464541,True,False,1434.0,1434.0,,,
441,rps_lng-HDO22251847,2022-06-21T00:00:00+01:00,Payment,Tenant Payment,Tenancy Receipt Ref: 33/88FRANKLINSTREE,True,False,1434.0,1434.0,1434.0,,
442,rps_lng-HDO22254051,2022-06-23T00:00:00+01:00,Debit Adjustment,Tenant Payment,Dishonoured Direct Debit: Tenancy Receipt Ref: 33/88FRANKLINSTREE,False,True,1434.0,1434.0,,,
443,rps_lng-HDO22302779,2022-07-21T00:00:00+01:00,Payment,Tenant Payment,Tenancy Receipt Ref: 33/88FRANKLINSTREE,True,False,1434.0,1434.0,1434.0,,
444,rps_lng-HDO22292812,2022-07-21T00:00:00+01:00,Invoice,Rent,Rent from 21/07/2022 to 20/08/2022 for 33/88 Franklin Street,False,True,1434.0,1434.0,,,
445,rps_lng-HDO22305512,2022-07-22T00:00:00+01:00,Payment,Tenant Payment,Tenancy Receipt Ref: DEFT Bpay 46464541,True,False,1434.0,1434.0,1434.0,,
446,rps_lng-HDO22305747,2022-07-25T00:00:00+01:00,Debit Adjustment,Tenant Payment,Dishonoured Direct Debit: Tenancy Receipt Ref: 33/88FRANKLINSTREE,False,True,1434.0,1434.0,,,
447,rps_lng-HDO22341457,2022-08-21T00:00:00+01:00,Invoice,Rent,Rent from 21/08/2022 to 20/09/2022 for 33/88 Franklin Street,False,True,1434.0,1434.0,-1434.0,,
448,rps_lng-HDO22351651,2022-08-22T00:00:00+01:00,Payment,Tenant Payment,Tenancy Receipt Ref: DEFT Bpay 46464541,True,False,1434.0,1434.0,,,
449,rps_lng-HDO22352078,2022-08-22T00:00:00+01:00,Payment,Tenant Payment,Tenancy Receipt Ref: 33/88FRANKLINSTREE,True,False,1434.0,1434.0,1434.0,,
450,rps_lng-HDO22353966,2022-08-24T00:00:00+01:00,Debit Adjustment,Tenant Payment,Dishonoured Direct Debit: Tenancy Receipt Ref: 33/88FRANKLINSTREE,False,True,1434.0,1434.0,,,
451,rps_lng-HDO22400401,2022-09-21T00:00:00+01:00,Invoice,Rent,Rent from 21/09/2022 to 20/10/2022 for 33/88 Franklin Street,False,True,1434.0,1434.0,-1434.0,,
452,rps_lng-HDO22409888,2022-09-21T00:00:00+01:00,Payment,Tenant Payment,Tenancy Receipt Ref: DEFT Bpay 46464541,True,False,1434.0,1434.0,,,
453,rps_lng-HDO22410052,2022-09-21T00:00:00+01:00,Payment,Tenant Payment,Tenancy Receipt Ref: 33/88FRANKLINSTREE,True,False,1434.0,1434.0,1434.0,,
454,rps_lng-HDO22413431,2022-09-26T00:00:00+01:00,Debit Adjustment,Tenant Payment,Dishonoured Direct Debit: Tenancy Receipt Ref: 33/88FRANKLINSTREE,False,True,1434.0,1434.0,,,
455,rps_lng-HDO22446096,2022-10-21T00:00:00+01:00,Invoice,Rent,Rent from 21/10/2022 to 20/11/2022 for 33/88 Franklin Street,False,True,1434.0,1434.0,-1434.0,,
456,rps_lng-HDO22458420,2022-10-24T00:00:00+01:00,Payment,Tenant Payment,Tenancy Receipt Ref: DEFT Bpay 46464541,True,False,1434.0,1434.0,,,
457,rps_lng-HDO22458741,2022-10-24T00:00:00+01:00,Payment,Tenant Payment,Tenancy Receipt Ref: 33/88FRANKLINSTREE,True,False,1434.0,1434.0,1434.0,,
458,rps_lng-HDO22460502,2022-10-26T00:00:00+01:00,Debit Adjustment,Tenant Payment,Dishonoured Direct Debit: Tenancy Receipt Ref: 33/88FRANKLINSTREE,False,True,1434.0,1434.0,,,
459,rps_lng-HDO22495166,2022-11-21T00:00:00+00:00,Invoice,Rent,Rent from 21/11/2022 to 20/12/2022 for 33/88 Franklin Street,False,True,1434.0,1434.0,-1434.0,,
460,rps_lng-HDO22505442,2022-11-22T00:00:00+00:00,Payment,Tenant Payment,Tenancy Receipt Ref: DEFT Bpay 46464541,True,False,1434.0,1434.0,,,
461,rps_lng-HDO22505752,2022-11-22T00:00:00+00:00,Payment,Tenant Payment,Tenancy Receipt Ref: 33/88FRANKLINSTREE,True,False,1434.0,1434.0,1434.0,,
462,rps_lng-HDO22507349,2022-11-24T00:00:00+00:00,Debit Adjustment,Tenant Payment,Dishonoured Direct Debit: Tenancy Receipt Ref: 33/88FRANKLINSTREE,False,True,1434.0,1434.0,,,
463,rps_lng-HDO22548167,2022-12-20T00:00:00+00:00,Payment,Tenant Payment,Tenancy Receipt Ref: DEFT Bpay 46464541,True,False,1434.0,1434.0,1434.0,,
464,rps_lng-HDO22541764,2022-12-21T00:00:00+00:00,Invoice,Rent,Rent from 21/12/2022 to 20/01/2023 for 33/88 Franklin Street,False,True,1434.0,1434.0,,,
465,rps_lng-HDO23025517,2023-01-16T00:00:00+00:00,Payment,Tenant Payment,Tenancy Receipt Ref: 33/88FRANKLINSTREE,True,False,1434.0,1434.0,1434.0,,
466,rps_lng-HDO23027032,2023-01-18T00:00:00+00:00,Debit Adjustment,Tenant Payment,Dishonoured Direct Debit: Tenancy Receipt Ref: 33/88FRANKLINSTREE,False,True,1434.0,1434.0,,,
467,rps_lng-HDO23021799,2023-01-21T00:00:00+00:00,Invoice,Rent,Rent from 21/01/2023 to 20/02/2023 for 33/88 Franklin Street,False,True,1434.0,1434.0,-1434.0,,
468,rps_lng-HDO23036138,2023-01-23T00:00:00+00:00,Payment,Tenant Payment,Tenancy Receipt Ref: DEFT Bpay 46464541,True,False,1434.0,1434.0,,,
469,rps_lng-HDO23036470,2023-01-23T00:00:00+00:00,Payment,Tenant Payment,Tenancy Receipt Ref: 33/88FRANKLINSTREE,True,False,1434.0,1434.0,1434.0,,
470,rps_lng-HDO23038058,2023-01-25T00:00:00+00:00,Debit Adjustment,Tenant Payment,Dishonoured Direct Debit: Tenancy Receipt Ref: 33/88FRANKLINSTREE,False,True,1434.0,1434.0,,,
471,rps_lng-HDO23079933,2023-02-21T00:00:00+00:00,Payment,Tenant Payment,Tenancy Receipt Ref: 33/88FRANKLINSTREE,True,False,1434.0,1434.0,1434.0,,
472,rps_lng-HDO23070147,2023-02-21T00:00:00+00:00,Invoice,Rent,Rent from 21/02/2023 to 20/03/2023 for 33/88 Franklin Street,False,True,1434.0,1434.0,,,
473,rps_lng-HDO23082470,2023-02-22T00:00:00+00:00,Payment,Tenant Payment,Tenancy Receipt Ref: DEFT Bpay 46464541,True,False,1434.0,1434.0,1434.0,,
474,rps_lng-HDO23082688,2023-02-23T00:00:00+00:00,Debit Adjustment,Tenant Payment,Dishonoured Direct Debit: Tenancy Receipt Ref: 33/88FRANKLINSTREE,False,True,1434.0,1434.0,,,
475,rps_lng-HDO23117524,2023-03-21T00:00:00+00:00,Invoice,Rent,Rent from 21/03/2023 to 20/04/2023 for 33/88 Franklin Street,False,True,1521.0,1521.0,-1521.0,,
476,rps_lng-HDO23126240,2023-03-21T00:00:00+00:00,Payment,Tenant Payment,Tenancy Receipt Ref: DEFT Bpay 46464541,True,False,1521.0,1521.0,,,
477,rps_lng-HDO23126388,2023-03-21T00:00:00+00:00,Payment,Tenant Payment,Tenancy Receipt Ref: 33/88FRANKLINSTREE,True,False,1521.0,1521.0,1521.0,,
478,rps_lng-HDO23128724,2023-03-23T00:00:00+00:00,Debit Adjustment,Tenant Payment,Dishonoured Direct Debit: Tenancy Receipt Ref: 33/88FRANKLINSTREE,False,True,1521.0,1521.0,,,
479,rps_lng-HDO23170724,2023-04-19T00:00:00+01:00,Payment,Tenant Payment,Tenancy Receipt Ref: DEFT Bpay 46464541,True,False,1521.0,1521.0,1521.0,,
480,rps_lng-HDO23163275,2023-04-21T00:00:00+01:00,Invoice,Rent,Rent from 21/04/2023 to 20/05/2023 for 33/88 Franklin Street,False,True,1521.0,1521.0,,,
481,rps_lng-HDO23211118,2023-05-21T00:00:00+01:00,Invoice,Rent,Rent from 21/05/2023 to 20/06/2023 for 33/88 Franklin Street,False,True,1521.0,1521.0,-1521.0,,
482,rps_lng-HDO23222139,2023-05-22T00:00:00+01:00,Payment,Tenant Payment,Tenancy Receipt Ref: DEFT Bpay 46464541,True,False,1521.0,1521.0,,,
483,rps_lng-HDO23222486,2023-05-22T00:00:00+01:00,Payment,Tenant Payment,Tenancy Receipt Ref: 33/88FRANKLINSTREE,True,False,1521.0,1521.0,1521.0,,
484,rps_lng-HDO23224462,2023-05-24T00:00:00+01:00,Debit Adjustment,Tenant Payment,Dishonoured Direct Debit: Tenancy Receipt Ref: 33/88FRANKLINSTREE,False,True,1521.0,1521.0,,,
485,rps_lng-HDO23258103,2023-06-21T00:00:00+01:00,Invoice,Rent,Rent from 21/06/2023 to 20/07/2023 for 33/88 Franklin Street,False,True,1521.0,1521.0,-1521.0,,
486,rps_lng-HDO23267894,2023-06-21T00:00:00+01:00,Payment,Tenant Payment,Tenancy Receipt Ref: DEFT Bpay 46464541,True,False,1521.0,1521.0,,,
487,rps_lng-HDO23268090,2023-06-21T00:00:00+01:00,Payment,Tenant Payment,Tenancy Receipt Ref: 33/88FRANKLINSTREE,True,False,1521.0,1521.0,1521.0,,
488,rps_lng-HDO23270908,2023-06-23T00:00:00+01:00,Debit Adjustment,Tenant Payment,Dishonoured Direct Debit: Tenancy Receipt Ref: 33/88FRANKLINSTREE,False,True,1521.0,1521.0,,,
489,rps_lng-HDO23304541,2023-07-11T00:00:00+01:00,Payment,Tenant Payment,Tenancy Receipt Ref: DEFT Bpay 46464541,True,False,1521.0,1521.0,1521.0,,
490,rps_lng-HDO23309138,2023-07-21T00:00:00+01:00,Invoice,Rent,Rent from 21/07/2023 to 20/08/2023 for 33/88 Franklin Street,False,True,1521.0,1521.0,,,
491,rps_lng-HDO23336500,2023-08-01T00:00:00+01:00,Payment,Tenant Payment,Tenancy Receipt Ref: DEFT Bpay 46464541,True,False,1521.0,1521.0,1521.0,1521.0,
492,rps_lng-,2022-03-11T00:00:00+00:00,Opening Balance CR,Float,Opening Balance,False,False,,,,,
493,rps_lng-HDO22107860,2022-03-11T00:00:00+00:00,Payment,Tenant Payment,Tenancy Receipt Ref: DEFT Bpay 46464541,True,False,2868.0,2868.0,2868.0,,
494,rps_lng-HDO22110518,2022-03-16T00:00:00+00:00,Invoice,Deposit,Deposit invoice,False,True,1434.0,1434.0,1434.0,,
495,rps_lng-HDO22110519,2022-03-16T00:00:00+00:00,,Deposit,Deposit held,True,False,1434.0,1434.0,2868.0,,
496,rps_lng-HDO22128738,2022-03-21T00:00:00+00:00,Invoice,Rent,Rent from 21/03/2022 to 20/04/2022 for 33/88 Franklin Street,False,True,1434.0,1434.0,1434.0,,
497,rps_lng-HDO22119996,2022-03-23T00:00:00+00:00,Invoice,,Transfer deposit to deposit protection scheme. Ref: 15286610,False,True,1434.0,1434.0,,,
498,rps_lng-HDO22160665,2022-04-21T00:00:00+01:00,Payment,Tenant Payment,Tenancy Receipt Ref: 33/88FRANKLINSTREE,True,False,1434.0,1434.0,1434.0,,
499,rps_lng-HDO22153549,2022-04-21T00:00:00+01:00,Invoice,Rent,Rent from 21/04/2022 to 20/05/2022 for 33/88 Franklin Street,False,True,1434.0,1434.0,,,
500,rps_lng-HDO22166560,2022-04-26T00:00:00+01:00,Debit Adjustment,Tenant Payment,Dishonoured Direct Debit: Tenancy Receipt Ref: 33/88FRANKLINSTREE,False,True,1434.0,1434.0,-1434.0,,
501,rps_lng-HDO22166561,2022-04-26T00:00:00+01:00,Invoice,Tenant Admin Fee,Dishonour Fee,False,True,25.0,25.0,-1459.0,,
502,rps_lng-HDO22173886,2022-04-29T00:00:00+01:00,Payment,Tenant Payment,Tenancy Receipt Ref: DEFT Bpay 46464541,True,False,1459.0,1459.0,,,
503,rps_lng-HDO22196712,2022-05-21T00:00:00+01:00,Invoice,Rent,Rent from 21/05/2022 to 20/06/2022 for 33/88 Franklin Street,False,True,1434.0,1434.0,-1434.0,,
504,rps_lng-HDO22209063,2022-05-23T00:00:00+01:00,Payment,Tenant Payment,Tenancy Receipt Ref: DEFT Bpay 46464541,True,False,1434.0,1434.0,,,
505,rps_lng-HDO22209386,2022-05-23T00:00:00+01:00,Payment,Tenant Payment,Tenancy Receipt Ref: 33/88FRANKLINSTREE,True,False,1434.0,1434.0,1434.0,,
506,rps_lng-HDO22211033,2022-05-25T00:00:00+01:00,Debit Adjustment,Tenant Payment,Dishonoured Direct Debit: Tenancy Receipt Ref: 33/88FRANKLINSTREE,False,True,1434.0,1434.0,,,
507,rps_lng-HDO22243671,2022-06-21T00:00:00+01:00,Invoice,Rent,Rent from 21/06/2022 to 20/07/2022 for 33/88 Franklin Street,False,True,1434.0,1434.0,-1434.0,,
508,rps_lng-HDO22251709,2022-06-21T00:00:00+01:00,Payment,Tenant Payment,Tenancy Receipt Ref: DEFT Bpay 46464541,True,False,1434.0,1434.0,,,
509,rps_lng-HDO22251847,2022-06-21T00:00:00+01:00,Payment,Tenant Payment,Tenancy Receipt Ref: 33/88FRANKLINSTREE,True,False,1434.0,1434.0,1434.0,,
510,rps_lng-HDO22254051,2022-06-23T00:00:00+01:00,Debit Adjustment,Tenant Payment,Dishonoured Direct Debit: Tenancy Receipt Ref: 33/88FRANKLINSTREE,False,True,1434.0,1434.0,,,
511,rps_lng-HDO22302779,2022-07-21T00:00:00+01:00,Payment,Tenant Payment,Tenancy Receipt Ref: 33/88FRANKLINSTREE,True,False,1434.0,1434.0,1434.0,,
512,rps_lng-HDO22292812,2022-07-21T00:00:00+01:00,Invoice,Rent,Rent from 21/07/2022 to 20/08/2022 for 33/88 Franklin Street,False,True,1434.0,1434.0,,,
513,rps_lng-HDO22305512,2022-07-22T00:00:00+01:00,Payment,Tenant Payment,Tenancy Receipt Ref: DEFT Bpay 46464541,True,False,1434.0,1434.0,1434.0,,
514,rps_lng-HDO22305747,2022-07-25T00:00:00+01:00,Debit Adjustment,Tenant Payment,Dishonoured Direct Debit: Tenancy Receipt Ref: 33/88FRANKLINSTREE,False,True,1434.0,1434.0,,,
515,rps_lng-HDO22341457,2022-08-21T00:00:00+01:00,Invoice,Rent,Rent from 21/08/2022 to 20/09/2022 for 33/88 Franklin Street,False,True,1434.0,1434.0,-1434.0,,
516,rps_lng-HDO22351651,2022-08-22T00:00:00+01:00,Payment,Tenant Payment,Tenancy Receipt Ref: DEFT Bpay 46464541,True,False,1434.0,1434.0,,,
517,rps_lng-HDO22352078,2022-08-22T00:00:00+01:00,Payment,Tenant Payment,Tenancy Receipt Ref: 33/88FRANKLINSTREE,True,False,1434.0,1434.0,1434.0,,
518,rps_lng-HDO22353966,2022-08-24T00:00:00+01:00,Debit Adjustment,Tenant Payment,Dishonoured Direct Debit: Tenancy Receipt Ref: 33/88FRANKLINSTREE,False,True,1434.0,1434.0,,,
519,rps_lng-HDO22400401,2022-09-21T00:00:00+01:00,Invoice,Rent,Rent from 21/09/2022 to 20/10/2022 for 33/88 Franklin Street,False,True,1434.0,1434.0,-1434.0,,
520,rps_lng-HDO22409888,2022-09-21T00:00:00+01:00,Payment,Tenant Payment,Tenancy Receipt Ref: DEFT Bpay 46464541,True,False,1434.0,1434.0,,,
521,rps_lng-HDO22410052,2022-09-21T00:00:00+01:00,Payment,Tenant Payment,Tenancy Receipt Ref: 33/88FRANKLINSTREE,True,False,1434.0,1434.0,1434.0,,
522,rps_lng-HDO22413431,2022-09-26T00:00:00+01:00,Debit Adjustment,Tenant Payment,Dishonoured Direct Debit: Tenancy Receipt Ref: 33/88FRANKLINSTREE,False,True,1434.0,1434.0,,,
523,rps_lng-HDO22446096,2022-10-21T00:00:00+01:00,Invoice,Rent,Rent from 21/10/2022 to 20/11/2022 for 33/88 Franklin Street,False,True,1434.0,1434.0,-1434.0,,
524,rps_lng-HDO22458420,2022-10-24T00:00:00+01:00,Payment,Tenant Payment,Tenancy Receipt Ref: DEFT Bpay 46464541,True,False,1434.0,1434.0,,,
525,rps_lng-HDO22458741,2022-10-24T00:00:00+01:00,Payment,Tenant Payment,Tenancy Receipt Ref: 33/88FRANKLINSTREE,True,False,1434.0,1434.0,1434.0,,
526,rps_lng-HDO22460502,2022-10-26T00:00:00+01:00,Debit Adjustment,Tenant Payment,Dishonoured Direct Debit: Tenancy Receipt Ref: 33/88FRANKLINSTREE,False,True,1434.0,1434.0,,,
527,rps_lng-HDO22495166,2022-11-21T00:00:00+00:00,Invoice,Rent,Rent from 21/11/2022 to 20/12/2022 for 33/88 Franklin Street,False,True,1434.0,1434.0,-1434.0,,
528,rps_lng-HDO22505442,2022-11-22T00:00:00+00:00,Payment,Tenant Payment,Tenancy Receipt Ref: DEFT Bpay 46464541,True,False,1434.0,1434.0,,,
529,rps_lng-HDO22505752,2022-11-22T00:00:00+00:00,Payment,Tenant Payment,Tenancy Receipt Ref: 33/88FRANKLINSTREE,True,False,1434.0,1434.0,1434.0,,
530,rps_lng-HDO22507349,2022-11-24T00:00:00+00:00,Debit Adjustment,Tenant Payment,Dishonoured Direct Debit: Tenancy Receipt Ref: 33/88FRANKLINSTREE,False,True,1434.0,1434.0,,,
531,rps_lng-HDO22548167,2022-12-20T00:00:00+00:00,Payment,Tenant Payment,Tenancy Receipt Ref: DEFT Bpay 46464541,True,False,1434.0,1434.0,1434.0,,
532,rps_lng-HDO22541764,2022-12-21T00:00:00+00:00,Invoice,Rent,Rent from 21/12/2022 to 20/01/2023 for 33/88 Franklin Street,False,True,1434.0,1434.0,,,
533,rps_lng-HDO23025517,2023-01-16T00:00:00+00:00,Payment,Tenant Payment,Tenancy Receipt Ref: 33/88FRANKLINSTREE,True,False,1434.0,1434.0,1434.0,,
534,rps_lng-HDO23027032,2023-01-18T00:00:00+00:00,Debit Adjustment,Tenant Payment,Dishonoured Direct Debit: Tenancy Receipt Ref: 33/88FRANKLINSTREE,False,True,1434.0,1434.0,,,
535,rps_lng-HDO23021799,2023-01-21T00:00:00+00:00,Invoice,Rent,Rent from 21/01/2023 to 20/02/2023 for 33/88 Franklin Street,False,True,1434.0,1434.0,-1434.0,,
536,rps_lng-HDO23036138,2023-01-23T00:00:00+00:00,Payment,Tenant Payment,Tenancy Receipt Ref: DEFT Bpay 46464541,True,False,1434.0,1434.0,,,
537,rps_lng-HDO23036470,2023-01-23T00:00:00+00:00,Payment,Tenant Payment,Tenancy Receipt Ref: 33/88FRANKLINSTREE,True,False,1434.0,1434.0,1434.0,,
538,rps_lng-HDO23038058,2023-01-25T00:00:00+00:00,Debit Adjustment,Tenant Payment,Dishonoured Direct Debit: Tenancy Receipt Ref: 33/88FRANKLINSTREE,False,True,1434.0,1434.0,,,
539,rps_lng-HDO23079933,2023-02-21T00:00:00+00:00,Payment,Tenant Payment,Tenancy Receipt Ref: 33/88FRANKLINSTREE,True,False,1434.0,1434.0,1434.0,,
540,rps_lng-HDO23070147,2023-02-21T00:00:00+00:00,Invoice,Rent,Rent from 21/02/2023 to 20/03/2023 for 33/88 Franklin Street,False,True,1434.0,1434.0,,,
541,rps_lng-HDO23082470,2023-02-22T00:00:00+00:00,Payment,Tenant Payment,Tenancy Receipt Ref: DEFT Bpay 46464541,True,False,1434.0,1434.0,1434.0,,
542,rps_lng-HDO23082688,2023-02-23T00:00:00+00:00,Debit Adjustment,Tenant Payment,Dishonoured Direct Debit: Tenancy Receipt Ref: 33/88FRANKLINSTREE,False,True,1434.0,1434.0,,,
543,rps_lng-HDO23117524,2023-03-21T00:00:00+00:00,Invoice,Rent,Rent from 21/03/2023 to 20/04/2023 for 33/88 Franklin Street,False,True,1521.0,1521.0,-1521.0,,
544,rps_lng-HDO23126240,2023-03-21T00:00:00+00:00,Payment,Tenant Payment,Tenancy Receipt Ref: DEFT Bpay 46464541,True,False,1521.0,1521.0,,,
545,rps_lng-HDO23126388,2023-03-21T00:00:00+00:00,Payment,Tenant Payment,Tenancy Receipt Ref: 33/88FRANKLINSTREE,True,False,1521.0,1521.0,1521.0,,
546,rps_lng-HDO23128724,2023-03-23T00:00:00+00:00,Debit Adjustment,Tenant Payment,Dishonoured Direct Debit: Tenancy Receipt Ref: 33/88FRANKLINSTREE,False,True,1521.0,1521.0,,,
547,rps_lng-HDO23170724,2023-04-19T00:00:00+01:00,Payment,Tenant Payment,Tenancy Receipt Ref: DEFT Bpay 46464541,True,False,1521.0,1521.0,1521.0,,
548,rps_lng-HDO23163275,2023-04-21T00:00:00+01:00,Invoice,Rent,Rent from 21/04/2023 to 20/05/2023 for 33/88 Franklin Street,False,True,1521.0,1521.0,,,
549,rps_lng-HDO23211118,2023-05-21T00:00:00+01:00,Invoice,Rent,Rent from 21/05/2023 to 20/06/2023 for 33/88 Franklin Street,False,True,1521.0,1521.0,-1521.0,,
550,rps_lng-HDO23222139,2023-05-22T00:00:00+01:00,Payment,Tenant Payment,Tenancy Receipt Ref: DEFT Bpay 46464541,True,False,1521.0,1521.0,,,
551,rps_lng-HDO23222486,2023-05-22T00:00:00+01:00,Payment,Tenant Payment,Tenancy Receipt Ref: 33/88FRANKLINSTREE,True,False,1521.0,1521.0,1521.0,,
552,rps_lng-HDO23224462,2023-05-24T00:00:00+01:00,Debit Adjustment,Tenant Payment,Dishonoured Direct Debit: Tenancy Receipt Ref: 33/88FRANKLINSTREE,False,True,1521.0,1521.0,,,
553,rps_lng-HDO23258103,2023-06-21T00:00:00+01:00,Invoice,Rent,Rent from 21/06/2023 to 20/07/2023 for 33/88 Franklin Street,False,True,1521.0,1521.0,-1521.0,,
554,rps_lng-HDO23267894,2023-06-21T00:00:00+01:00,Payment,Tenant Payment,Tenancy Receipt Ref: DEFT Bpay 46464541,True,False,1521.0,1521.0,,,
555,rps_lng-HDO23268090,2023-06-21T00:00:00+01:00,Payment,Tenant Payment,Tenancy Receipt Ref: 33/88FRANKLINSTREE,True,False,1521.0,1521.0,1521.0,,
556,rps_lng-HDO23270908,2023-06-23T00:00:00+01:00,Debit Adjustment,Tenant Payment,Dishonoured Direct Debit: Tenancy Receipt Ref: 33/88FRANKLINSTREE,False,True,1521.0,1521.0,,,
557,rps_lng-HDO23304541,2023-07-11T00:00:00+01:00,Payment,Tenant Payment,Tenancy Receipt Ref: DEFT Bpay 46464541,True,False,1521.0,1521.0,1521.0,,
558,rps_lng-HDO23309138,2023-07-21T00:00:00+01:00,Invoice,Rent,Rent from 21/07/2023 to 20/08/2023 for 33/88 Franklin Street,False,True,1521.0,1521.0,,,
559,rps_lng-HDO23336500,2023-08-01T00:00:00+01:00,Payment,Tenant Payment,Tenancy Receipt Ref: DEFT Bpay 46464541,True,False,1521.0,1521.0,1521.0,1521.0,
560,rps_lng-,2022-10-27T00:00:00+01:00,Opening Balance CR,Float,Opening Balance,False,False,,,,,
561,rps_lng-HDO22466892,2022-10-27T00:00:00+01:00,Payment,Tenant Payment,Tenancy Receipt Ref: DEFT Bpay 48329080,True,False,1738.0,1738.0,1738.0,,
562,rps_lng-HDO22467266,2022-10-28T00:00:00+01:00,Invoice,Deposit,Deposit invoice,False,True,1738.0,1738.0,,,
563,rps_lng-HDO22467267,2022-10-28T00:00:00+01:00,,Deposit,Deposit held,True,False,1738.0,1738.0,1738.0,,
564,rps_lng-HDO22483813,2022-11-08T00:00:00+00:00,Invoice,,Transfer deposit to deposit protection scheme. Ref: 15448112,False,True,1738.0,1738.0,,,
565,rps_lng-HDO22486851,2022-11-09T00:00:00+00:00,Payment,Tenant Payment,Tenancy Receipt Ref: DEFT Bpay 48329080,True,False,1738.0,1738.0,1738.0,,
566,rps_lng-HDO22501720,2022-11-18T00:00:00+00:00,Invoice,Rent,Rent from 18/11/2022 to 17/12/2022 for 7/9 Denbigh Road,False,True,1738.0,1738.0,,,
567,rps_lng-HDO22535936,2022-12-18T00:00:00+00:00,Invoice,Rent,Rent from 18/12/2022 to 17/01/2023 for 7/9 Denbigh Road,False,True,1738.0,1738.0,-1738.0,,
568,rps_lng-HDO22546532,2022-12-19T00:00:00+00:00,Payment,Tenant Payment,Tenancy Receipt Ref: 7/9DENBIGHROAD,True,False,1738.0,1738.0,,,
569,rps_lng-HDO22548192,2022-12-20T00:00:00+00:00,Payment,Tenant Payment,Tenancy Receipt Ref: DEFT Bpay 48329080,True,False,1738.0,1738.0,1738.0,,
570,rps_lng-HDO22548391,2022-12-21T00:00:00+00:00,Debit Adjustment,Tenant Payment,Dishonoured Direct Debit: Tenancy Receipt Ref: 7/9DENBIGHROAD,False,True,1738.0,1738.0,,,
571,rps_lng-HDO23028467,2023-01-18T00:00:00+00:00,Payment,Tenant Payment,Tenancy Receipt Ref: 7/9DENBIGHROAD,True,False,1738.0,1738.0,1738.0,,
572,rps_lng-HDO23019925,2023-01-18T00:00:00+00:00,Invoice,Rent,Rent from 18/01/2023 to 17/02/2023 for 7/9 Denbigh Road,False,True,1738.0,1738.0,,,
573,rps_lng-HDO23030218,2023-01-20T00:00:00+00:00,Debit Adjustment,Tenant Payment,Dishonoured Direct Debit: Tenancy Receipt Ref: 7/9DENBIGHROAD,False,True,1738.0,1738.0,-1738.0,,
574,rps_lng-HDO23041067,2023-01-25T00:00:00+00:00,Payment,Tenant Payment,Tenancy Receipt Ref: DEFT Bpay 48329080,True,False,1738.0,1738.0,,,
575,rps_lng-HDO23063968,2023-02-18T00:00:00+00:00,Invoice,Rent,Rent from 18/02/2023 to 17/03/2023 for 7/9 Denbigh Road,False,True,1738.0,1738.0,-1738.0,,
576,rps_lng-HDO23077349,2023-02-20T00:00:00+00:00,Payment,Tenant Payment,Tenancy Receipt Ref: 7/9DENBIGHROAD,True,False,1738.0,1738.0,,,
577,rps_lng-HDO23079978,2023-02-22T00:00:00+00:00,Debit Adjustment,Tenant Payment,Dishonoured Direct Debit: Tenancy Receipt Ref: 7/9DENBIGHROAD,False,True,1738.0,1738.0,-1738.0,,
578,rps_lng-HDO23088910,2023-02-24T00:00:00+00:00,Payment,Tenant Payment,Tenancy Receipt Ref: DEFT Bpay 48329080,True,False,1738.0,1738.0,,,
579,rps_lng-HDO23111509,2023-03-18T00:00:00+00:00,Invoice,Rent,Rent from 18/03/2023 to 17/04/2023 for 7/9 Denbigh Road,False,True,1738.0,1738.0,-1738.0,,
580,rps_lng-HDO23124287,2023-03-20T00:00:00+00:00,Payment,Tenant Payment,Tenancy Receipt Ref: DEFT Bpay 48329080,True,False,1738.0,1738.0,,,
581,rps_lng-HDO23124488,2023-03-20T00:00:00+00:00,Payment,Tenant Payment,Tenancy Receipt Ref: 7/9DENBIGHROAD,True,False,1738.0,1738.0,1738.0,,
582,rps_lng-HDO23126482,2023-03-22T00:00:00+00:00,Debit Adjustment,Tenant Payment,Dishonoured Direct Debit: Tenancy Receipt Ref: 7/9DENBIGHROAD,False,True,1738.0,1738.0,,,
583,rps_lng-HDO23139703,2023-03-29T00:00:00+01:00,Payment,Tenant Payment,Tenancy Receipt Ref: DEFT Bpay 48329080,True,False,220.0,220.0,220.0,,
584,rps_lng-HDO23141041,2023-03-30T00:00:00+01:00,Invoice,Tenant Admin Fee,Tenant Transfer Fee,False,True,220.0,200.0,,,20.0
585,rps_lng-HDO23169189,2023-04-18T00:00:00+01:00,Payment,Tenant Payment,Tenancy Receipt Ref: 7/9DENBIGHROAD,True,False,1738.0,1738.0,1738.0,,
586,rps_lng-HDO23159441,2023-04-18T00:00:00+01:00,Invoice,Rent,Rent from 18/04/2023 to 17/05/2023 for 7/9 Denbigh Road,False,True,1738.0,1738.0,,,
587,rps_lng-HDO23170741,2023-04-19T00:00:00+01:00,Payment,Tenant Payment,Tenancy Receipt Ref: DEFT Bpay 48329080,True,False,1738.0,1738.0,1738.0,,
588,rps_lng-HDO23170944,2023-04-20T00:00:00+01:00,Debit Adjustment,Tenant Payment,Dishonoured Direct Debit: Tenancy Receipt Ref: 7/9DENBIGHROAD,False,True,1738.0,1738.0,,,
589,rps_lng-HDO23217250,2023-05-18T00:00:00+01:00,Payment,Tenant Payment,Tenancy Receipt Ref: 7/9DENBIGHROAD,True,False,1738.0,1738.0,1738.0,,
590,rps_lng-HDO23208311,2023-05-18T00:00:00+01:00,Invoice,Rent,Rent from 18/05/2023 to 17/06/2023 for 7/9 Denbigh Road,False,True,1738.0,1738.0,,,
591,rps_lng-HDO23219840,2023-05-22T00:00:00+01:00,Invoice,Tenant Admin Fee,Dishonour Fee,False,True,25.0,25.0,-25.0,25.0,
592,rps_lng-HDO23219839,2023-05-22T00:00:00+01:00,Debit Adjustment,Tenant Payment,Dishonoured Direct Debit: Tenancy Receipt Ref: 7/9DENBIGHROAD,False,True,1738.0,1738.0,-1763.0,,
593,rps_lng-HDO23222168,2023-05-22T00:00:00+01:00,Payment,Tenant Payment,Tenancy Receipt Ref: DEFT Bpay 48329080,True,False,1738.0,1738.0,-25.0,,
594,rps_lng-HDO23251850,2023-06-18T00:00:00+01:00,Invoice,Rent,Rent from 18/06/2023 to 17/07/2023 for 7/9 Denbigh Road,False,True,1738.0,1738.0,-1763.0,,
595,rps_lng-HDO23264044,2023-06-19T00:00:00+01:00,Payment,Tenant Payment,Tenancy Receipt Ref: 7/9DENBIGHROAD,True,False,1738.0,1738.0,-25.0,,
596,rps_lng-HDO23265857,2023-06-20T00:00:00+01:00,Payment,Tenant Payment,Tenancy Receipt Ref: DEFT Bpay 48329080,True,False,1738.0,1738.0,1713.0,,
597,rps_lng-HDO23266086,2023-06-21T00:00:00+01:00,Debit Adjustment,Tenant Payment,Dishonoured Direct Debit: Tenancy Receipt Ref: 7/9DENBIGHROAD,False,True,1738.0,1738.0,-25.0,,
598,rps_lng-HDO23314591,2023-07-18T00:00:00+01:00,Payment,Tenant Payment,Tenancy Receipt Ref: 7/9DENBIGHROAD,True,False,1738.0,1738.0,1713.0,,
599,rps_lng-HDO23305791,2023-07-18T00:00:00+01:00,Invoice,Rent,Rent from 18/07/2023 to 17/08/2023 for 7/9 Denbigh Road,False,True,1738.0,1738.0,-25.0,,
600,rps_lng-HDO23316130,2023-07-19T00:00:00+01:00,Payment,Tenant Payment,Tenancy Receipt Ref: DEFT Bpay 48329080,True,False,1738.0,1738.0,1713.0,,
601,rps_lng-HDO23316358,2023-07-20T00:00:00+01:00,Debit Adjustment,Tenant Payment,Dishonoured Direct Debit: Tenancy Receipt Ref: 7/9DENBIGHROAD,False,True,1738.0,1738.0,-25.0,,
